蜘蛛侠：英雄远征 导演: 乔·沃茨; 
蜘蛛侠：英雄归来3 导演: 乔·沃茨; 
钢铁侠4 导演: 暂无
大侦探皮卡丘 导演: 罗伯·莱特曼; 
流浪地球 导演: 郭帆; 
何以为家 导演: 娜丁·拉巴基; 
老师·好 导演: 张栾; 
复仇者联盟4：终局之战 导演: 乔·罗素; 安东尼·罗素; 
下一任：前任 导演: 陈鸿仪; 邱晧洲; 
比悲伤更悲伤的故事 导演: 林孝谦; 
蜘蛛侠：英雄归来 导演: 乔·沃茨; 
惊奇队长 导演: 安娜·波顿; 瑞安·弗雷克; 
调音师 导演: 斯里兰姆·拉格万; 
千与千寻 导演: 宫崎骏; 柯克·维斯; 
速度与激情：特别行动 导演: 大卫·雷奇; 
小丑 导演: 托德·菲利普斯; 
反贪风暴4 导演: 林德禄; 
黑寡妇 导演: 凯特·休特兰; 
疯狂的外星人 导演: 宁浩; 
蜘蛛侠：平行宇宙 导演: 鲍勃·佩尔西凯蒂; 彼得·拉姆齐; 
一个母亲的复仇 导演: 拉维·德耶瓦尔; 
复仇者联盟3：无限战争 导演: 安东尼·罗素; 乔·罗素; 
驯龙高手3 导演: 迪恩·德布洛斯; 
银河护卫队3 导演: 詹姆斯·古恩; 
超凡蜘蛛侠2 导演: 马克·韦布; 
速度与激情9 导演: 林诣彬; 
钢铁侠3 导演: 沙恩·布莱克; 
名侦探柯南：绀青之拳 导演: 暂无
奇异博士2 导演: 斯科特·德瑞克森; 
进京城 导演: 胡玫; 
熊出没·原始时代 导演: 丁亮; 林汇达; 
战狼2 导演: 吴京; 
阿凡达2 导演: 詹姆斯·卡梅隆; 
绿皮书 导演: 彼得·法雷里; 
雪暴 导演: 崔斯韦; 
复仇蜘蛛侠 导演: CameronDodd; 
阿凡达 导演: 詹姆斯·卡梅隆; 
罗马 导演: 阿方索·卡隆; 
战狼3 导演: 吴京; 
黑豹2 导演: 瑞恩·库格勒; 
雷霆沙赞！ 导演: 大卫·F·桑德伯格; 
风中有朵雨做的云 导演: 娄烨; 
港珠澳大桥 导演: 闫东; 
前任3：再见前任 导演: 田羽生; 
如影随心 导演: 霍建起; 
毒液2 导演: 鲁本·弗雷斯彻; 
阿丽塔：战斗天使 导演: 罗伯特·罗德里格兹; 
地久天长 导演: 王小帅; 
狗眼看人心 导演: 吴楠; 
海贼王：狂热行动 导演: 暂无
撞死了一只羊 导演: 万玛才旦; 
小丑回魂2 导演: 安德斯·穆斯切蒂; 
复仇者联盟 导演: 乔斯·韦登; 
人间·喜剧 导演: 孙周; 
速度与激情10 导演: 林诣彬; 
哥斯拉 导演: 加里斯·爱德华斯; 
钢铁侠 导演: 乔恩·费儒; 
波西米亚狂想曲 导演: 布莱恩·辛格; 
死侍3 导演: 大卫·雷奇; 
恐怖片 导演: WilliamA.Levey; 
夏目友人帐 导演: 大森贵弘; 
天上再见 导演: 阿尔贝·杜邦泰尔; 
午夜怪谈 导演: 卫立洲; 
天气之子 导演: 新海诚; 
复仇者联盟2：奥创纪元 导演: 乔斯·韦登; 
钢铁侠：噬甲危机 导演: 浜崎博嗣; 
X战警：新变种人 导演: 约什·布恩; 
蜘蛛侠3 导演: 山姆·雷米; 
南方车站的聚会 导演: 刁亦男; 
最后的魁拔 导演: 王川; 
狮子王 导演: 乔恩·费儒; 
蜘蛛侠 导演: 山姆·雷米; 
飞驰人生 导演: 韩寒; 
祈祷落幕时 导演: 福泽克雄; 
贞子 导演: 中田秀夫; 
小飞象 导演: 蒂姆·波顿; 
海王 导演: 温子仁; 
大侦探皮卡丘2 导演: 暂无
全职高手之巅峰荣耀 导演: 史涓生; 邓志巍; 
哥斯拉大战金刚 导演: 亚当·温加德; 
假面骑士平成世代 FINAL Build & EX-AID with 传说骑士 导演: 暂无
雷神3：诸神黄昏 导演: 塔伊加·维迪提; 
叶问4 导演: 叶伟信; 
一条狗的使命 导演: 拉斯·霍尔斯道姆; 
死侍2：我爱我家 导演: 大卫·雷奇; 
蜘蛛侠：龙之挑战 导演: 唐·麦克杜格尔; 
钢铁侠2 导演: 乔恩·费儒; 
毒液：致命守护者 导演: 鲁本·弗雷斯彻; 
冰雪奇缘2 导演: 珍妮弗·李; 克里斯·巴克; 
美国队长3 导演: 安东尼·罗素; 乔·罗素; 
超凡蜘蛛侠 导演: 马克·韦布; 
我的英雄学院：两位英雄 导演: 长崎健司; 
白蛇：缘起 导演: 黄家康; 赵霁; 
新喜剧之王 导演: 周星驰; 邱礼涛; 
我不是药神 导演: 文牧野; 
反贪风暴5 导演: 林德禄; 
光天化日 导演: 王大庆; 
奇异博士 导演: 斯科特·德瑞克森; 
比悲伤更悲伤的故事 导演: 元泰渊; 
冰之下 导演: 蔡尚君; 
未命名的漫威电影 导演: 暂无
地狱男爵：血皇后崛起 导演: 尼尔·马歇尔; 
速度与激情8 导演: F·加里·格雷; 
动物出击 导演: 冯小宁; 
永恒族 导演: 赵婷; 
蜘蛛侠2 导演: 山姆·雷米; 
银河护卫队2 导演: 詹姆斯·古恩; 
泰坦尼克号3D 导演: 詹姆斯·卡梅隆; 
追龙 导演: 王晶; 关智耀; 
绝色黑寡妇 导演: PeterDiamond; 
红海行动 导演: 林超贤; 
美国队长 导演: 乔·庄斯顿; 
小丑回魂 导演: 安德斯·穆斯切蒂; 
变形金刚7 导演: 暂无
蜘蛛侠：英雄归来，NBA总决赛：观看比赛 导演: 暂无
疾速备战 导演: 查德·斯塔赫斯基; 
阿凡达3：带种者 导演: 詹姆斯·卡梅隆; 
正义联盟2 导演: 扎克·施奈德; 
欢迎来北方II 导演: 丹尼·伯恩; 
蜘蛛侠2：另一个世界 导演: JoeyLever; 
宝莱坞机器人2.0:重生归来 导演: 史蒂夫·格里芬; S·尚卡尔; 
无名之辈 导演: 饶晓志; 
速度与激情：增压 导演: ThierryCoup; 
半边天 导演: 刘雨霖; 丹妮拉·托马斯; 
银河护卫队 导演: 詹姆斯·古恩; 
美国队长2 导演: 安东尼·罗素; 乔·罗素; 
X战警：天启 导演: 布莱恩·辛格; 
“大”人物 导演: 五百; 
黑豹 导演: 瑞恩·库格勒; 
刺猬索尼克 导演: 杰夫·福勒; 
龙猫 导演: 宫崎骏; 
蚁人2：黄蜂女现身 导演: 佩顿·里德; 
转型团伙 导演: 吴镇宇; 
泰坦尼克号 导演: 詹姆斯·卡梅隆; 
海市蜃楼 导演: 奥里奥尔·保罗; 
西虹市首富 导演: 闫非; 彭大魔; 
神奇乐园历险记 导演: 迪兰·布朗; 
黑衣人3 导演: 巴里·索南菲尔德; 
调音师 导演: 奥利维耶·特雷内; 
十二金刚 导演: 王晶; 
漫威影业：宇宙集结 导演: 暂无
爱情公寓 导演: 韦正; 
听‧见 林俊杰 导演: 暂无
恐怖快递 导演: 杨振豪; 
雷神2：黑暗世界 导演: 阿兰·泰勒; 
唐人街探案2 导演: 陈思诚; 
寒战3 导演: 陆剑青; 梁乐民; 
雷神 导演: 肯尼思·布拉纳; 乔斯·韦登; 
雷霆沙赞2 导演: 大卫·F·桑德伯格; 
大鱼海棠 导演: 梁旋; 张春; 
悲伤逆流成河 导演: 落落; 
悟空奇遇记 导演: 殷玉麒; 
星球大战9：天行者崛起 导演: 科林·特雷沃罗; J·J·艾布拉姆斯; 
大黄蜂 导演: 特拉维斯·奈特; 
美人鱼2 导演: 周星驰; 
乐高漫威复仇者联盟：重新集结 导演: RobSilvestri; 
死侍，黑豹，铁手套 导演: 加勒特·H.迪马; 
速度与激情7 导演: 温子仁; 
特别追踪 导演: 王启蘅; 
最佳男友进化论 导演: 林子聪; 
X战警：逆转未来 导演: 布莱恩·辛格; 
拆弹专家2 导演: 邱礼涛; 
蜘蛛侠 导演: 暂无
前任2：备胎反击战 导演: 田羽生; 
金刚狼3：殊死一战 导演: 詹姆斯·曼高德; 
高四糊涂生 导演: 苏月禾; 
阿凡达5：追寻伊娃 导演: 詹姆斯·卡梅隆; 
变形金刚5：最后的骑士 导演: 迈克尔·贝; 
金刚：骷髅岛 导演: 乔丹·沃格特-罗伯茨; 
阿凡达4：祖古骑士 导演: 詹姆斯·卡梅隆; 
名侦探柯南：零的执行人 导演: 立川让; 
终极蜘蛛侠之死 导演: AndrewS.Bates; ThomasAndrewLawson; 
加勒比海盗6：四海之怒 导演: 乔阿吉姆·罗恩尼; 
青春期猪头少年不做怀梦少女的梦 导演: 増井壮一; 
无敌浩克 导演: 路易斯·莱特里尔; 
巴尔干边界 导演: 安德烈·沃金; 
名侦探柯南OVA11：来自伦敦的秘密指令 导演: 暂无
蝙蝠侠：黑暗骑士 导演: 克里斯托弗·诺兰; 
鬼片王之再现凶榜 导演: 刘孝伟; 
最伟大的美国恐怖片 导演: SeanTretta; 
忌日快乐2 导演: 克里斯托弗·兰登; 
魁拔V 导演: 王川; 
扫毒 导演: 陈木胜; 
正义联盟 导演: 扎克·施奈德; 
狂暴凶狮 导演: 迪克·麦斯; 
雷神成人版 导演: 暂无
惊奇队长的奇妙冒险 导演: 约翰·昂格利什; 威廉·威特尼; 
后来的我们 导演: 刘若英; 
偷心女盗 导演: 克里斯·艾迪生; 
环太平洋：雷霆再起 导演: 斯蒂文·S·迪奈特; 
利刃破冰 导演: 彭发; 
鬼吹灯之天星术 导演: 李依璠; 西蒙·韦斯特; 
海王2 导演: 温子仁; 
死侍 导演: 蒂姆·米勒; 
一出好戏 导演: 黄渤; 
蝙蝠侠 导演: 本·阿弗莱克; 马特·里夫斯; 
神奇女侠 导演: 派蒂·杰金斯; 
你的名字。 导演: 新海诚; 
美人鱼 导演: 周星驰; 林子聪; 
侏罗纪世界2 导演: 胡安·安东尼奥·巴亚纳; 
蝙蝠侠大战超人：正义黎明 导演: 扎克·施奈德; 
铁拳雄心 导演: 周玉清; 
情圣2 导演: 宋晓飞; 董旭; 
紧急救援 导演: 林超贤; 
境·界 导演: 佐藤信介; 
脱单记 导演: 康锐; 
地球最后的夜晚 导演: 毕赣; 
一吻定情 导演: 陈玉珊; 
过春天 导演: 白雪; 
周杰伦摩天轮演唱会 2014 导演: 暂无
蜡笔小新：新婚旅行飓风之遗失的野原广志 导演: 桥本昌和; 
嘿玛 嘿玛 导演: 宗萨钦哲仁波切; 
星球大战：原力觉醒 导演: J·J·艾布拉姆斯; 
阳台上 导演: 张猛; 
蚁人 导演: 佩顿·里德; 
明日战记 导演: 罗志良; 吴炫辉; 
黑衣人 导演: 巴里·索南菲尔德; 
钢铁侠与美国队长：英雄集结 导演: 埃里克·拉多姆斯基; LeoRiley; 
三体 导演: 张番番; 
快把我哥带走 导演: 郑芬芬; 
驯龙高手2 导演: 迪恩·德布洛斯; 
绿巨人浩克 导演: 李安; 
无双 导演: 庄文强; 
密室逃生 导演: 亚当·罗比特尔; 
素媛 导演: 李濬益; 
摔跤吧！爸爸 导演: 涅提·蒂瓦里; 
东北虎 导演: 耿军; 
疯狂动物城 导演: 拜伦·霍华德; 瑞奇·摩尔; 
狂怒沙暴 导演: 斯科特·沃; 
在乎你 导演: 毕国智; 
我想吃掉你的胰脏 导演: 牛岛新一郎; 
一条狗的回家路 导演: 查尔斯·马丁·史密斯; 
虎影侠 导演: 暂无
同人哆啦A梦：大雄的喜马拉雅行进记 导演: 暂无
哥斯拉：噬星者 导演: 静野孔文; 濑下宽之; 
叶问之九龙城寨 导演: 暂无
角头2：王者再起 导演: 颜正国; 
蜘蛛侠超能力探秘 导演: RickHull; 
侏罗纪世界3 导演: 科林·特雷沃罗; 
X战警3：背水一战 导演: 布莱特·拉特纳; 
英雄无侠 导演: 周文扬; 
廉政风云 导演: 麦兆辉; 
冰海陷落 导演: 多诺万·玛什; 
鬼照片 导演: 暂无
爱宠大机密 导演: 克里斯·雷纳德; 亚罗·切尼; 
守灵 导演: 李东; 
斩毒行动 导演: 暂无
X战警：第一战 导演: 马修·沃恩; 
别哭妈妈 导演: 果生; 
命运之夜——天之杯：迷失之蝶 导演: 须藤友德; 
冰雪奇缘 导演: 克里斯·巴克; 珍妮弗·李; 
钢铁飞龙之奥特曼崛起 导演: 王巍; 
一路疯癫 导演: 崔守杰; 
新哥斯拉 导演: 庵野秀明; 樋口真嗣; 
来电狂响 导演: 于淼; 
使徒行者 导演: 文伟鸿; 王晶; 
自杀小队 导演: 大卫·阿耶; 
变形金刚4：绝迹重生 导演: 迈克尔·贝; 
罗布奥特曼剧场版：决定了！羁绊的水晶 导演: 暂无
敢问路在何方 导演: 暂无
羞羞的铁拳 导演: 宋阳; 张吃鱼; 
头号玩家 导演: 史蒂文·斯皮尔伯格; 
失恋复仇者联盟 导演: 王晶; 
反贪风暴3 导演: 林德禄; 
大侦探福尔摩斯3 导演: 盖·里奇; 
两块钱之钱途太囧 导演: 暂无
功夫2 导演: 周星驰; 
巨齿鲨 导演: 乔·德特杜巴; 
李娜 导演: 陈可辛; 
变形金刚8 导演: 暂无
感动她77次 导演: 邱礼涛; 
肥龙过江 导演: 王晶; 谷垣健治; 
拳皇2019 导演: 国庆; 
749局 导演: 陆川; 
自杀小队2 导演: 加文·欧康诺; 詹姆斯·古恩; 
午夜凶铃：贞子复活 导演: 木下高男; 西谷弘; 
从你的全世界路过 导演: 张一白; 
动物世界 导演: 韩延; 
星球大战：最后的绝地武士 导演: 莱恩·约翰逊; 
神奇宝贝：皮卡丘探险队 导演: 迈克尔·海格尼; 汤山邦彦; 
憨豆特工3 导演: 大卫·科尔; 
神奇女侠1984 导演: 派蒂·杰金斯; 
熊出没·变形记 导演: 丁亮; 林汇达; 
碟中谍6：全面瓦解 导演: 克里斯托弗·麦奎里; 
我为兄弟狂 导演: 任鹏; 
看不见的客人 导演: 奥里奥尔·保罗; 
X战警 导演: 布莱恩·辛格; 
疾速追杀 导演: 大卫·雷奇; 查德·斯塔赫斯基; 
喜剧之王 导演: 李力持; 周星驰; 
哆啦A梦：大雄的金银岛 导演: 今井一晓; 柳承莞; 
移情大师 导演: 郑来志; 
雷神小队：第二部分 导演: 塔伊加·维迪提; 
爵迹 导演: 郭敬明; 
黑衣人2 导演: 巴里·索南菲尔德; 
奇异博士 导演: 杰伊·欧力瓦; FrankPaur; 
非常交易 导演: 黄健; 
妈妈再爱我一次 导演: 陈朱煌; 
速度与激情6 导演: 林诣彬; 
死侍与黑豹：回到红与黑 导演: 布拉德·加内特; 加勒特·H.迪马; 
记忆切割 导演: 果靖霖; 
朝花夕誓-于离别之朝束起约定之花 导演: 筱原俊哉; 冈田麿里; 
超时空同居 导演: 苏伦; 
大破天门阵 导演: 陆诗雷; 
星际穿越 导演: 克里斯托弗·诺兰; 
夺宝大师 导演: 丁大海; 郭绍恒; 
恐怖电影院2 导演: 陆诗雷; 
机动战士高达NT 导演: 暂无
恐龙王 导演: 施雅雅; 
大象席地而坐 导演: 胡波; 
龙珠：超级赛亚人灭绝计划 导演: 上田芳裕; 
加勒比海盗5：死无对证 导演: 乔阿吉姆·罗恩尼; 艾斯彭·山德伯格; 
捉妖记2 导演: 许诚毅; 
寻梦环游记 导演: 李·昂克里奇; 阿德里安·莫利纳; 
乐高大电影2 导演: 迈克·米切尔; 
幕后玩家 导演: 任鹏远; 
再见班花 导演: 暂无
建军大业 导演: 刘伟强; 
怪医杜立德 导演: 斯蒂芬·加汉; 
芳华 导演: 冯小刚; 
金刚狼 导演: 加文·胡德; 
命运之夜——天之杯：恶兆之花 导演: 须藤友德; 
火影忍者剧场版：博人传 导演: 山下宏幸; 
极速追杀 导演: 暂无
守护神之绝境营救 导演: JimmyHenderson; 吉米·亨德森; 
芳龄十六 导演: 丹尼什卡·埃斯特哈奇; 
黑寡妇 导演: 阿曼德·马斯楚安尼; 
恐怖 导演: 高桥洋; 
小猪佩奇过大年 导演: 张大鹏; NevilleAstley; 
环太平洋 导演: 吉尔莫·德尔·托罗; 
湄公河行动 导演: 林超贤; 
阿修罗 导演: 张鹏; 张鹏; 
哥斯拉 导演: 罗兰·艾默里奇; 
比卡丘之捉迷藏 导演: 暂无
超人、蜘蛛侠或蝙蝠侠 导演: 图多尔·久尔玖; 
精灵宝可梦：波尔凯尼恩与机巧的玛机雅娜 导演: 汤山邦彦; 
代号·反抗 导演: 王子; 蓝海瀚; 
小偷家族 导演: 是枝裕和; 
终结者：黑暗命运 导演: 蒂姆·米勒; 
邪不压正 导演: 姜文; 
冰雪奇缘：生日惊喜 导演: 克里斯·巴克; 珍妮弗·李; 
七月与安生 导演: 曾国祥; 
速度与激情 导演: 罗伯·科恩; 
釜山行 导演: 延尚昊; 
魔兽 导演: 邓肯·琼斯; 
狂暴巨兽 导演: 布拉德·佩顿; 
我的世界 导演: 罗布·麦克尔亨尼; 彼得·苏列特; 
X战警2 导演: 布莱恩·辛格; 
金刚狼2 导演: 詹姆斯·曼高德; 
神探蒲松龄 导演: 严嘉; 
泰坦尼克号2 导演: 肖恩·范·戴克; 
疾速特攻 导演: 查德·斯塔赫斯基; 
老男孩 导演: 斯派克·李; 
叶问外传：张天志 导演: 袁和平; 
机甲战神孙悟空 导演: 暂无
李茶的姑妈 导演: 吴昱翰; 
嗝嗝老师 导演: 西达尔特·马尔霍特拉; 
东北往事之破马张飞 导演: 郭大雷; 
三重威胁之跨国大营救 导演: 杰西·约翰逊; 查德·斯塔赫斯基; 
风再起时 导演: 翁子光; 
好莱坞往事 导演: 昆汀·塔伦蒂诺; 
敢死队4 导演: 暂无
追钱逗爱熊仁镇 导演: 查慕春; 
王牌特工：大博弈 导演: 马修·沃恩; 
前任 导演: 卡洛·万齐纳; 
名侦探柯南特典：怪盗基德诞生的秘密 导演: 暂无
北斗风云 导演: 马玉辉; 魏子千; 
蝙蝠侠：黑暗骑士崛起 导演: 克里斯托弗·诺兰; 
七龙珠：赛亚人传说 导演: GeorgeKirby; HarryKirby; 
深海危机 导演: 沈东; 
风林火山 导演: 麦浚龙; 
天国之渡 导演: 赵汉唐; 
命运之夜——天之杯3：春之歌 导演: 须藤友德; 
侏罗纪世界 导演: 科林·特雷沃罗; 
影 导演: 张艺谋; 
奥特曼vs假面骑士 导演: 圆谷一夫; 
欲念游戏 导演: 郭涛; 
把哥哥退货可以吗 导演: 维塔亚·东俞扬; 
昨日青空 导演: 奚超; 
无敌破坏王2：大闹互联网 导演: 瑞奇·摩尔; 菲尔·约翰斯顿; 
超人：钢铁之躯 导演: 扎克·施奈德; 
驯龙高手 导演: 迪恩·德布洛斯; 克里斯·桑德斯; 
德鲁大叔 导演: 查尔斯·斯通三世; 
照相师 导演: 张唯; 
原来如此 导演: 廖必翔; 
哈利·波特与魔法石 导演: 克里斯·哥伦布; 
闪电侠 导演: 乔纳森·M·戈尔茨坦; 约翰·弗朗西斯·戴利; 
捕捉阿凡达 导演: 劳伦·布罗泽; 
无疯也起浪 导演: 李智; 
死侍：危险行为 导演: 大卫·雷奇; 
长城 导演: 张艺谋; 
愤怒的小鸟2 导演: 约翰·赖斯; 图鲁普·范·奥尔曼; 
碟中谍7 导演: 克里斯托弗·麦奎里; 
大黄蜂2 导演: 暂无
醒来之爱的呼唤 导演: 王陆涛; 
忌日快乐 导演: 克里斯托弗·兰登; 
建国大业 导演: 韩三平; 黄建新; 
速度与激情5 导演: 林诣彬; 
京剧猫：霸王折 导演: 许刚; 
超胆侠大战蜘蛛侠 导演: 暂无
调音师 导演: 琪拉·穆拉托娃; 
假面骑士Build：只有一个答案 导演: 暂无
宝莱坞机器人之恋 导演: S·尚卡尔; 
银河护卫队：地狱 导演: 詹姆斯·古恩; 大卫·雅洛维斯基; 
黄金兄弟 导演: 钱嘉乐; 
神奇动物：格林德沃之罪 导演: 大卫·叶茨; 
老炮儿 导演: 管虎; 
小丑 导演: 乔·沃茨; 
世上只有爸爸好 导演: 黄汝乐; 
远去的牧歌 导演: 阿迪夏·夏热合曼; 周军; 
反贪风暴 导演: 林德禄; 
笑盗江湖 导演: 崔俊杰; 
疯狂外星人 导演: 蒂姆·约翰逊; 尼古拉斯·麦卡锡; 
江湖儿女 导演: 贾樟柯; 
木兰传说 导演: 妮琪·卡罗; 
贞子3D 导演: 英勉; 
惊悚 导演: 莎莉·波特; 
阿拉丁与神灯 导演: 亚瑟·邦扎康; 
生化危机：终章 导演: 保罗·安德森; 
牌皇 导演: 戈尔·维宾斯基; 
寻秦记 导演: 陈木胜; 徐克; 
肖申克的救赎 导演: 弗兰克·德拉邦特; 
狗十三 导演: 曹保平; 
动物世界2 导演: 韩延; 
狮子王 导演: 罗杰·阿勒斯; 罗伯·明可夫; 
未来机器城 导演: 安恪温; 龙子乔; 
急先锋 导演: 唐季礼; 
九克拉战栗 导演: 林峻兆; 
印度合伙人 导演: R·巴尔基; 
夏目友人帐：曾几何时下雪之日 导演: 大森贵弘; 
神奇四侠 导演: 蒂姆·斯托瑞; 
拆弹·专家 导演: 邱礼涛; 
一代宗师3D 导演: 王家卫; 
奇迹男孩 导演: 斯蒂芬·卓博斯基; 
五月天追梦 导演: 孔玟燕; 曲全立; 
魔兽2 导演: 邓肯·琼斯; 
鬼吹灯之龙岭迷窟 导演: 朴柱天; 
守边人 导演: 方军亮; 
云南虫谷 导演: 非行; 
寒战2 导演: 梁乐民; 陆剑青; 
托尔金 导演: 多姆·卡如库斯基; 
惊天魔盗团2 导演: 朱浩伟; 
当幸福来敲门 导演: 加布里埃莱·穆奇诺; 
美国队长3(英雄内战) 导演: 暂无
无问西东 导演: 李芳芳; 
从21世纪安全撤离 导演: 李阳; 
黑衣人：异形入侵 导演: 大卫·C·科布; 琳达·哈桑尼; 
盗墓笔记 导演: 李仁港; 
解忧杂货店 导演: 韩杰; 
西游记女儿国 导演: 郑保瑞; 
岁月忽已暮 导演: 秦小珍; 
哥斯拉：怪兽行星 导演: 静野孔文; 濑下宽之; 
勇敢者游戏：决战丛林 导演: 杰克·卡斯丹; 
王者天下 导演: 佐藤信介; 
唐山大地震 导演: 冯小刚; 
猫公主苏菲 导演: 潘智超; 王玉; 
亮光 导演: 大卫·雅洛维斯基; 
与神同行：罪与罚 导演: 金容华; 
变形金刚3 导演: 迈克尔·贝; 
妖猫传 导演: 陈凯歌; 
为家而战 导演: 斯戴芬·莫昌特; 
麦兜我和我妈妈 导演: 谢立文; 李俊民; 
西伯利亚风云 导演: 金子修介; 
超人总动员2 导演: 布拉德·伯德; 
法医秦明之舐犊情深 导演: 史岳; 
找到你 导演: 吕乐; 
霸王别姬 导演: 陈凯歌; 
哆啦A梦：伴我同行 导演: 山崎贵; 八木龙一; 
生化危机4D：执行者 导演: 大畑晃一; 
反贪风暴2 导演: 林德禄; 
祖宗十九代 导演: 郭德纲; 
深夜食堂 导演: 梁家辉; 
双生日本版 导演: 熊坂出; 
王牌特工2：黄金圈 导演: 马修·沃恩; 
北京·晚九朝五 导演: 房祖名; 
冷血追击 导演: 汉斯·皮特·莫郎; 
安娜贝尔回家 导演: 加里·多伯曼; 
厉害了，我的国 导演: 卫铁; 
黑社会3 导演: 杜琪峰; 
画个圈圈 导演: 王子鸣; 
乘风破浪 导演: 韩寒; 
重庆森林 导演: 王家卫; 
蓝色生死恋 导演: 王才涛; 
勇敢者游戏2 导演: 杰克·卡斯丹; 
假面骑士平成世代 FINAL Build & EX-AID with 传说骑士 导演: 暂无
指环王3：王者无敌 导演: 彼得·杰克逊; 
云雾笼罩的山峰 导演: 左志国; 
一级指控 导演: 黄国辉; 
天下父母 导演: 崔守杰; 
捍卫者 导演: 廖希; 韩平; 
掠食城市 导演: 克里斯蒂安·瑞沃斯; 
欢迎来北方 导演: 丹尼·伯恩; 
第一滴血5 导演: 西尔维斯特·史泰龙; 阿德里安·格鲁伯格; 
爱乐之城 导演: 达米恩·查泽雷; 
大侦探福尔摩斯 导演: 盖·里奇; 
宠物坟场 导演: 凯文·库尔施; 丹尼斯·维德迈尔; 
黑寡妇 导演: MarkRoemmich; 
僵尸世界大战2 导演: 大卫·芬奇; 
神奇动物在哪里3 导演: 大卫·叶茨; 
胖子行动队 导演: 包贝尔; 
神偷奶爸3 导演: 皮埃尔·柯芬; 凯尔·巴尔达; 
神秘巨星 导演: 阿德瓦·香登; 
闪光少女 导演: 王冉; 
代号基亚斯：复活的鲁路修 导演: 谷口悟朗; 
惊天魔盗团3 导演: 朱浩伟; 
真・雀鬼11 奪われた死闘 片腕の代走屋 导演: 暂无
笔仙大战贞子3结盟 导演: 暂无
大话西游之大圣娶亲 导演: 刘镇伟; 
大侦探福尔摩斯2：诡影游戏 导演: 盖·里奇; 
功夫 导演: 周星驰; 
小萝莉的猴神大叔 导演: 卡比尔·汗; 
地狱男爵2：黄金军团 导演: 吉尔莫·德尔·托罗; 
海门深处 导演: 李永超; 
猩球崛起3：终极之战 导演: 马特·里夫斯; 
乐高漫威超级英雄：银河护卫队之灭霸危机 导演: MichaelD.Black; 
毒液：真实的新闻 导演: 乔·林奇; FernandoPhagabeefy; 
哭泣女人的诅咒 导演: 迈克尔·查维斯; 
蜡笔小新：爆盛！功夫男孩〜拉面大乱〜 导演: 高桥涉; 
雷神小队3 导演: 塔伊加·维迪提; 
新白蛇传 导演: 暂无
新乌龙院之笑闹江湖 导演: 朱延平; 
哈利·波特与死亡圣器（下） 导演: 大卫·叶茨; 
动画片 导演: 比尔·普莱姆顿; 
鹰眼 导演: D·J·卡卢索; 
星球大战外传：侠盗一号 导演: 加里斯·爱德华斯; 
雪怪大冒险 导演: 格伦·费卡拉; 杰森·雷西格; 
盗梦空间 导演: 克里斯托弗·诺兰; 
游戏人生ZERO 导演: 石塚敦子; 
美食大冒险之英雄烩 导演: 孙海鹏; 
宝贝老板 导演: 汤姆·麦格拉思; 
别告诉她 导演: 王璐; 
神奇四侠2015 导演: 乔什·特兰克; 
恭喜八婆 导演: 彭浩翔; 
这个杀手不太冷 导演: 吕克·贝松; 
捉妖学院 导演: 田梓呈; 
杀破狼3 导演: 郑保瑞; 
源·彩虹 导演: 诺曼·斯通; 
风语咒 导演: 刘阔; 
航海王之黄金城 导演: 宮元宏彰; 
母子情深 导演: DrorShaul; 
你好，之华 导演: 岩井俊二; 
DC电影出品：正义联盟黎明 导演: EricMatthies; 
荞麦疯长 导演: 徐展雄; 
蝙蝠侠：侠影之谜 导演: 克里斯托弗·诺兰; 
恐龙当家 导演: 彼得·孙; 鲍勃·彼德森; 
金蝉脱壳3：恶魔车站 导演: 约翰·赫兹菲尔德; 
恐怖电影胶片 导演: AshleyFester; 
第十一回 导演: 陈建斌; 
非凡任务 导演: 麦兆辉; 潘耀明; 
一生有你 导演: 卢庚戌; 
马戏之王 导演: 迈克尔·格雷西; 
叶问3 导演: 叶伟信; 
缝纫机乐队 导演: 大鹏; 
情圣 导演: 宋晓飞; 董旭; 
精灵王座 导演: 宋岳峰; 
驴得水 导演: 周申; 刘露; 
麦子的盖头 导演: 鲁坚; 
星游记之冲出地球 导演: 胡一泊; 
驯龙高手番外篇：驯龙赛手的起源 导演: 约翰·桑福德; 
起立，老师好！ 导演: 暂无
瞒天过海：美人计 导演: 盖瑞·罗斯; 
封神三部曲 导演: 乌尔善; 
名侦探柯南OVA9：十年后的陌生人 导演: 暂无
三体2 导演: 张番番; 
虫林大作战 导演: 阿诺·布龙; 
悟空传 导演: 郭子健; 黄智亨; 
极限特工4 导演: D·J·卡卢索; 
四个春天 导演: 陆庆屹; 
灵魂战车 导演: 马克·斯蒂文·约翰逊; 
速度与激情3：东京漂移 导演: 林诣彬; 
惊天动地 导演: 王珈; 沈东; 
绿灯侠 导演: 马丁·坎贝尔; 
熊出没之雪岭熊风 导演: 丁亮; 刘富源; 
紫罗兰永恒花园 电影版 导演: 石立太一; 
疯狂动物城2 导演: 拜伦·霍华德; 
奇幻森林 导演: 乔恩·费儒; 
绿灯军团 导演: 乔治·米勒; 
切尔诺贝利·禁区电影版 导演: 暂无
天长地久 导演: 方军; 
变形金刚 导演: 迈克尔·贝; 
龙珠Z：复活的弗利萨 导演: 山室直仪; 
人再囧途之泰囧 导演: 徐峥; 
法医秦明之只如初见 导演: 史岳; 
绝密工程 导演: 石伟; 
变形金刚2 导演: 迈克尔·贝; 
魁拔之十万火急 导演: 王川; 
印度暴徒 导演: 维贾伊·克利须那·阿查里雅; 
再见，少年 导演: 殷若昕; 
万达，残暴的催眠师 导演: GregCorarito; 
中国蓝盔 导演: 宁海强; 
招魂2 导演: 温子仁; 
头号嫌疑人 导演: 李旗; 
守望者 导演: 扎克·施奈德; 
西游记之再世妖王 导演: 王云飞; 
小时代4：灵魂尽头 导演: 郭敬明; 
天气预爆 导演: 肖央; 
好好的活着 导演: 暂无
爬行 导演: 亚历山大·阿嘉; 
守望一生 导演: 倪榕; 于人; 
我的宠物是大象 导演: 邵晓黎; 
血战钢锯岭 导演: 梅尔·吉布森; 
钢铁侠与浩克：联合战记 导演: 埃里克·拉多姆斯基; LeoRiley; 
熊出没·奇幻空间 导演: 丁亮; 林永长; 
霍比特人3：五军之战 导演: 彼得·杰克逊; 
环球恐怖片 导演: 凯文·布朗洛; 
我的特工爷爷 导演: 洪金宝; 
功夫熊猫3 导演: 吕寅荣; 亚历山德罗·卡罗尼; 
三生三世十里桃花 导演: 赵小丁; 安东尼·拉默里纳拉; 
我的12个情人劫 导演: 廖子豪; 
三块广告牌 导演: 马丁·麦克唐纳; 
前度 导演: 麦曦茵; 
忠犬八公的故事 导演: 拉斯·霍尔斯道姆; 
星际迷航3：超越星辰 导演: 林诣彬; 
一条大鱼叫海棠 导演: 柏晓; 
怦然心动 导演: 罗伯·莱纳; 
十二个想死的孩子 导演: 堤幸彦; 
左耳 导演: 苏有朋; 
人间失格 导演: 蜷川实花; 
神奇女侠：血脉 导演: 暂无
被光抓走的人 导演: 暂无
闻烟 导演: 泷田洋二郎; 
盗梦特攻队 导演: 米洛拉德·科斯蒂奇; 
双子杀手 导演: 李安; 
美女与野兽 导演: 比尔·康顿; 
星游记之风暴法米拉II 导演: 胡一泊; 
加勒比海盗4：惊涛怪浪 导演: 罗伯·马歇尔; 
喜羊羊与灰太狼大电影8 导演: 黄伟明; 
太空旅客 导演: 莫滕·泰杜姆; 
移动迷宫3：死亡解药 导演: 韦斯·鲍尔; 
寂静之地 导演: 约翰·卡拉辛斯基; 
封神传奇 导演: 许安; 杨龙澄; 
敢问路在何方之殉难篇 导演: 暂无
真假美猴王之战神归来 导演: 江约诚; 罗乐; 
雷神回归 导演: BrettKelly; 
亲密旅行 导演: 沙溢; 
之后 导演: 暂无
妈妈别走 导演: 暂无
4D肉蒲团之扶桑千人斩 导演: 暂无
指环王1：护戒使者 导演: 彼得·杰克逊; 
憨豆特工2 导演: 奥利弗·帕克; 
Re：从零开始的异世界生活 冰结之绊 导演: 暂无
五尺天涯 导演: 贾斯汀·贝尔杜尼; 
让子弹飞 导演: 姜文; 
海兽之子 导演: 渡边步; 
大轰炸 导演: 萧锋; 
阿甘正传 导演: 罗伯特·泽米吉斯; 
嫌疑人x的献身 导演: 苏有朋; 
极限特工：终极回归 导演: D·J·卡卢索; 
西游记之孙悟空三打白骨精 导演: 郑保瑞; 
奎迪：英雄再起 导演: 小斯蒂芬·卡普尔; 
触不可及 导演: 奥利维埃·纳卡什; 埃里克·托莱达诺; 
2012 3D 导演: 罗兰·艾默里奇; 
印度奇游 导演: 张建亚; 
钢铁侠 导演: 拉尔夫·巴克希; ChuckHarriton; 
我爱喵星人 导演: 朴熙坤; 
麦路人 导演: 黄庆勋; 
功守道 导演: 文章; 
DC展台：超人与沙赞之黑亚当归来 导演: JoaquamDosSantos; 乔伊姆·多斯·桑托斯; 
烟花 导演: 新房昭之; 武内宣之; 
保持沉默 导演: 周可; 
德云社戊戌年封箱庆典2019 导演: 暂无
光天化日 导演: 暂无
武林怪兽 导演: 刘伟强; 
神奇四侠2 导演: 蒂姆·斯托瑞; 
21座桥 导演: 布莱恩·柯克; 
演员工作室：小罗伯特·唐尼 导演: 暂无
小丑与哈莉·奎恩：地下世界的情侣 导演: 暂无
玻璃先生 导演: M·奈特·沙马兰; 
老家伙们 导演: 张峰; 
兰心大剧院 导演: 娄烨; 
星际特工：千星之城 导演: 吕克·贝松; 
流浪猫鲍勃 导演: 罗杰·斯波蒂斯伍德; 
疯狂大爆炸 导演: IndraKumarGhosh; IndraKumar; 
大会师 导演: 安澜; 
熊出没的开垦地 导演: 铃木重吉; 
大侦探霍桑 导演: 周显扬; 
二十二 导演: 郭柯; 
澳门风云3 导演: 刘伟强; 王晶; 
哥斯拉大战机械哥斯拉 导演: 手塚昌明; 
狄仁杰之四大天王 导演: 徐克; 
赤道2 导演: 梁乐民; 陆剑青; 
猎狐者 导演: 林德禄; 
甲铁城的卡巴内瑞 总集篇后篇 燃烧的生命 导演: 暂无
疯狂的麦克斯4：狂暴之路 导演: 乔治·米勒; 
终结者：创世纪 导演: 阿兰·泰勒; 
名侦探柯南：唐红的恋歌 导演: 静野孔文; 
僵尸先生 导演: 刘观伟; 
摇滚学校 导演: 艾伦·亚克许; 乔·丹特; 
末代皇帝 导演: 贝纳尔多·贝托鲁奇; 
多啦美与哆啦A梦族：机器人学校七不思议 导演: 米谷良知; 
八个女人一台戏 导演: 关锦鹏; 
老爸的战争 导演: 安东尼奥·梅尔塞罗; 
灵魂的救赎 导演: 杨真; 
初恋这件小事 导演: 普特鹏·普罗萨卡·那·萨克那卡林; 华森·波克彭; 
精灵王座Ⅱ 导演: 宋岳峰; 
火影忍者真人版 导演: 迈克尔·格雷西; 
九层妖塔 导演: 陆川; 
空天猎 导演: 李晨; 
沉睡魔咒2：恶魔夫人 导演: 乔阿吉姆·罗恩尼; 
致我们终将逝去的青春 导演: 赵薇; 
谁的青春不迷茫 导演: 姚婷婷; 
超体2 导演: 吕克·贝松; 
黑衣人重启版2 导演: 暂无
速度与激情4 导演: 林诣彬; 
死亡通知单暗黑者：首部曲“双雄会” 导演: 翁子光; 邱礼涛; 
乐高大电影4D 导演: 罗布·施拉布; 
爱宠大机密2 导演: 暂无
金陵十三钗 导演: 张艺谋; 
神奇动物在哪里 导演: 大卫·叶茨; 
心理罪之城市之光 导演: 徐纪周; 
机密复仇者：黑寡妇与惩罚者 导演: 清水健一; 
华纳兄弟的恐怖片时代 导演: MarcusHearn; 
最近最远的你 导演: 刘城铭; 
一个明星的诞生 导演: 布莱德利·库珀; 
摩天营救 导演: 罗森·马歇尔·瑟伯; 
007：幽灵党 导演: 萨姆·门德斯; 
驯龙高手番外篇：龙的礼物 导演: 汤姆·欧文斯; 
狮子王2：辛巴的荣耀 导演: 达雷尔·鲁尼; 罗布·拉杜卡; 
招魂3 导演: 迈克尔·查维斯; 
罗马假日 导演: 威廉·惠勒; 
春江花月夜 导演: 宋灏霖; 
凡人修仙传动画大电影 导演: 川村泰; 
乐高漫威超级英雄 黑豹：瓦坎达危机 导演: MichaelD.Black; 
假面骑士Zi-O 导演: 暂无
猪猪侠之英雄猪少年 导演: 陆锦明; 钟彧; 
速度与激情2 导演: 约翰·辛格顿; 
318号公路 导演: 聂运兴; 
他其实没那么喜欢你 导演: 肯·卡皮斯; 
放牛班的春天 导演: 克里斯托夫·巴拉蒂; 
地久天长 导演: 杜国威; 
悬崖上的金鱼姬 导演: 宫崎骏; 
暴裂无声 导演: 忻钰坤; 
变形金刚：前传 导演: 暂无
国礼 导演: 周琦; 
泰迪熊 导演: 塞思·麦克法兰; 
欧洲攻略 导演: 马楚成; 
世界最大的影视城: 横店影视城 导演: 暂无
激情黑寡妇 导演: JohnPatrickKelley; 
触不可及(美版) 导演: 西蒙·柯蒂斯; 尼尔·博格; 
脱单告急 导演: 柯孟融; 
杀破狼·贪狼 导演: 叶伟信; 洪金宝; 
嘿玛嘿玛 导演: 钦哲·诺布; 
小飞象 导演: 威尔弗雷德·杰克逊; 宾·沙普斯坦; 
独立日：卷土重来 导演: 罗兰·艾默里奇; 
起跑线 导演: 萨基特·乔杜里; 
热血合唱团 导演: 关信辉; 
东邪西毒 导演: 王家卫; 
请以你的名字呼唤我 导演: 卢卡·瓜达尼诺; 
我想和你好好的 导演: 李蔚然; 
僵尸世界大战 导演: 马克·福斯特; 
第九区 导演: 尼尔·布洛姆坎普; 
战狼三级班 导演: 暂无
八月未央 导演: 李凯; 
大话西游之月光宝盒 导演: 刘镇伟; 
神奇蜘蛛侠 导演: E.W.Swackhamer; 
特种部队3 导演: D·J·卡卢索; 
恋爱的犀牛 导演: 孟京辉; 
侠盗联盟 导演: 冯德伦; 
消失的爱人 导演: 大卫·芬奇; 
穿越时空的少女 导演: 细田守; 
加勒比海盗 导演: 戈尔·维宾斯基; 
沉睡魔咒 导演: 罗伯特·斯特罗姆伯格; 
金刚 导演: 彼得·杰克逊; 
一纸婚约 导演: 张辉; 
西游·降魔篇 导演: 周星驰; 郭子健; 
猛禽小队与哈莉·奎茵的奇妙解放 导演: 阎羽茜; 
下一站爱情 导演: 蒋国权; 
精灵旅社3：疯狂假期 导演: 格恩迪·塔塔科夫斯基; 
超人：钢铁之躯2 导演: 乔治·米勒; 
画皮Ⅲ 导演: 暂无
疯狂的石头 导演: 宁浩; 
声之形 导演: 山田尚子; 
蜘蛛侠百战曱甴精 导演: 埃里克·马蒂; 
名侦探柯南：纯黑的恶梦 导演: 静野孔文; 
大师兄 导演: 阚家伟; 
游侠索罗：星球大战外传 导演: 朗·霍华德; 
功夫瑜伽 导演: 唐季礼; 
Trouble 导演: KevinJohnson; 
天才枪手 导演: 纳塔吾·彭皮里亚; 
为了明天 导演: 宋昭; 王永宏; 
寻找雷神锤子路上发生的趣事 导演: 雷森姆; 
为了明天 导演: 宋昭; 王永宏; 
非正式爱情 导演: 徐嘉亮; 
失恋博物馆 导演: 暂无
火影忍者剧场版：炎之中忍试验！鸣人VS木叶丸！ 导演: 暂无
老师好美 导演: 曾国祥; 
敢死队3 导演: 帕特里克·休斯; 
欢乐喜剧人 导演: 黎继强; 张子栋; 
28岁未成年 导演: 张末; 
电锯惊魂9:竖锯2 导演: 暂无
地狱男爵 导演: 吉尔莫·德尔·托罗; 
黑客帝国 导演: 莉莉·沃卓斯基; 拉娜·沃卓斯基; 
日月 导演: 金依萌; 
引爆者 导演: 常征; 
忍者神龟2：破影而出 导演: 戴夫·格林; 
火星救援 导演: 雷德利·斯科特; 
沦落人 导演: 陈小娟; 
天坑鹰猎 导演: 隋小东; 
匆匆那年 导演: 张一白; 
新灰姑娘 导演: 林恩·萨瑟兰; 
机动部队 导演: 杜琪峰; 罗永昌; 
侏罗纪公园3D 导演: 史蒂文·斯皮尔伯格; 
碟中谍5：神秘国度 导演: 克里斯托弗·麦奎里; 
黄大年 导演: 成科; 
异形：契约 导演: 雷德利·斯科特; 
精灵宝可梦：就决定是你了 导演: 汤山邦彦; 
七十七天 导演: 赵汉唐; 
网络谜踪 导演: 阿尼什·查甘蒂; 
星球大战 导演: 乔治·卢卡斯; 
龙虾刑警 导演: 李昕芸; 
灵怪博士 导演: PhilipDeGuere; 
速度与激情之A2狂飙 导演: 迈克尔·库奇; 
上海往事之当年情 导演: 陈家俊; 
玩具总动员3 导演: 李·昂克里奇; 
冰雪女王4：魔镜世界 导演: 阿列克谢·特斯蒂斯林; 刘凌峰; 
超能陆战队 导演: 唐·霍尔; 克里斯·威廉姆斯; 
角头 导演: 李运杰; 万仁; 
悠然见南山 导演: 顾伟; 
神偷奶爸4 Despicable Me 4 导演: 凯尔·巴尔达; 
少林寺 导演: 张鑫炎; 
巨额来电 导演: 彭顺; 
冈仁波齐 导演: 张杨; 
王牌特工：特工学院 导演: 马修·沃恩; 
灵魂战车2：复仇时刻 导演: 马克·耐沃尔代; 布莱恩·泰勒; 
铁血战士 导演: 沙恩·布莱克; 
我不是潘金莲 导演: 冯小刚; 
米娅和白狮 导演: GillesdeMaistre; 
怨灵2 导演: 李勇昌; 
一路向西 导演: 胡耀辉; 
钢骨 导演: 暂无
纯洁心灵·逐梦演艺圈 导演: 毕志飞; 
忍者神龟：变种时代 导演: 乔纳森·里贝斯曼; 
巴霍巴利王2：终结 导演: S·S·拉贾穆里; 
女王的柯基 导演: 本·斯塔森; 
指环王2：双塔奇兵 导演: 彼得·杰克逊; 
漫威崛起：钢铁之心 导演: 暂无
鬼吹灯之怒晴湘西 导演: 暂无
阿梅丽塔，毁灭 导演: 暂无
中国合伙人 导演: 陈可辛; 
惊奇僵尸：电影版 导演: 暂无
爸，我一定行的 导演: 蓝鸿春; 
小黄人大眼萌 导演: 凯尔·巴尔达; 皮埃尔·柯芬; 
原谅他77次 导演: 邱礼涛; 
古墓丽影：源起之战 导演: 罗阿尔·乌索格; 
愤怒的小鸟 导演: 费格尔·雷利; 克雷·卡提斯; 
暮光之城 导演: 凯瑟琳·哈德威克; 
钢铁苍穹2：即临种族 导演: 提莫·沃伦索拉; 
假面饭店 导演: 铃木雅之; 
龙珠Z剧场版7：极限之战!! 三大超级赛亚人 导演: 西尾大介; 
自杀小队：严厉惩罚 导演: 刘山姆; 
假面骑士亚马逊们剧场版 最后的审判 仮面ライダーアマゾンズ THE MOVIE 最後ノ審判 导演: 石田秀范; 
暴雪将至 导演: 董越; 
年轻妻子的工作：超VIP美容俱乐部 导演: 金田敬; 
不能说的秘密 导演: 周杰伦; 
阿拉丁 导演: 苏乔伊·高什; 
西游伏妖篇 导演: 徐克; 周星驰; 
大闹天竺 导演: 王宝强; 
我的少女时代 导演: 陈玉珊; 
霍比特人2：史矛革之战 导演: 彼得·杰克逊; 
终极复仇者2：黑豹的崛起 导演: WillMeugniot; 迪克·锡巴斯特; 
站住！小偷 导演: 郑云; 
胡桃夹子和四个王国 导演: 拉斯·霍尔斯道姆; 乔·庄斯顿; 
潜艇总动员：海底两万里 导演: 申宇; 
100万年地球之旅 班达之书 导演: 暂无
哈尔的移动城堡 导演: 宫崎骏; 
滚蛋吧！肿瘤君 导演: 韩延; 
咒怨 导演: 清水崇; 
东方快车谋杀案 导演: 肯尼思·布拉纳; 
犯罪现场 导演: 冯志强; 
记忆大师 导演: 陈正道; 
大话西游3 导演: 刘镇伟; 
小时代 导演: 郭敬明; 
招魂 导演: 温子仁; 
新天地 导演: 暂无
银魂2 导演: 福田雄一; 
时间遗墓1：九龙解棺 导演: 刁璐璐; 
月半爱丽丝 导演: 张林子; 
我是你妈 导演: 张骁; 
心跳二十七度 导演: 陈健; 
阳光不是劫匪 导演: 李玉; 
特警队 导演: 丁晟; 
赛尔号大电影5：雷神崛起 导演: 王章俊; 
纽约的一个雨天 导演: 伍迪·艾伦; 丹妮尔·里格比; 
魔女 导演: 金大佑; 朴勋政; 
明日边缘2：生死轮回 导演: 道格·里曼; 
哥斯拉复活 导演: 沈炯来; 
动物园长的夫人 导演: 妮琪·卡罗; 
新大头儿子和小头爸爸3：俄罗斯奇遇记 导演: 何澄; 
七龙珠 导演: 黄毅瑜; 
蜘蛛侠3：英国首映特典 导演: SteveKemsley; 
绣春刀II：修罗战场 导演: 路阳; 
伫在年少的尾巴上 导演: 暂无
恐怖游轮 导演: 克里斯托弗·史密斯; 
攀登者 导演: VladanSlijepcevic; 
特种部队2：全面反击 导演: 朱浩伟; 
恐婚大作战 导演: 刘涛滔; 
巧虎电影：巧虎与小白鲸的大冒险 导演: 暂无
斗罗大陆 导演: 暂无
野犬笔录 导演: 郝飞环; 
安娜贝尔 导演: 约翰·R·莱昂耐迪; 
独立日3 导演: 罗兰·艾默里奇; 
猛虫过江 导演: 小沈阳; 
真实恐怖灵异照片馆 导演: 清水崇; 
那些年，我们一起追的女孩 导演: 九把刀; 
特种部队：眼镜蛇的崛起 导演: 斯蒂芬·索莫斯; 
终结者2：审判日 导演: 詹姆斯·卡梅隆; 
至爱梵高·星空之谜 导演: 多洛塔·科别拉; 休·韦尔什曼; 
星球大战前传3：西斯的复仇 导演: 乔治·卢卡斯; 
假面骑士EX-AID Trilogy Another Ending Part III 假面骑士Genm VS 假面骑士Lazer 导演: 铃村展弘; 
加勒比海盗3：世界的尽头 导演: 戈尔·维宾斯基; 
路人女主的养成方法 Fine 导演: 龟井干太; 
山寨大黄蜂 导演: JamesKondelik; JonKondelik; 
昆池岩 导演: 郑凡植; 
山村老尸2：色之恶鬼 导演: 蓝志伟; 
机器之血 导演: 张立嘉; 
少年派的奇幻漂流 导演: 李安; 
扎职 导演: 陈翊恒; 
断片之险途夺宝 导演: 罗登; 
世上只有妈妈好 导演: 陈朱煌; 
轩辕大帝 导演: 李晓军; 
熊出没之夺宝熊兵 导演: 丁亮; 刘富源; 
星际迷航：暗黑无界 导演: J·J·艾布拉姆斯; 
速度超越激情 导演: 贾森·弗莱德伯格; 亚伦·赛尔策; 
复仇者之死 导演: 黄精甫; 
金刚大战哥斯拉 导演: 本多猪四郎; 
青蛙王子历险记 导演: 蒋叶峰; 
闪灵 导演: 斯坦利·库布里克; 
极限职业 导演: 李炳宪; 
霍比特人1：意外之旅 导演: 彼得·杰克逊; 
敢问路在何方之背叛篇 导演: 暂无
小时代4：灵魂尽头（含纪录片《最好的我们》） 导演: 郭敬明; 
明日边缘 导演: 道格·里曼; 
海贼王特别篇：空岛之章 导演: 暂无
孟买酒店 导演: 安东尼·马拉斯; 
狂徒 导演: 洪子烜; 
地心引力 导演: 阿方索·卡隆; 
生化危机5：惩罚 导演: 保罗·安德森; 
阿飞正传 导演: 王家卫; 
疯狂的麦克斯5：废土 导演: 乔治·米勒; 
泰坦尼克号2 导演: 詹姆斯·戴维·沃利; 
玩命速递：重启之战 导演: 卡米尔·狄拉玛; 
名侦探柯南OVA10：怪盗基德孤岛决战 导演: 儿玉兼嗣; 
爱丽丝梦游仙境2：镜中奇遇记 导演: 詹姆斯·博宾; 
哥斯拉之终极战役 导演: 北村龙平; 
亲爱的 导演: 陈可辛; 
华尔街之狼 导演: 马丁·斯科塞斯; 
天空之城 导演: 宫崎骏; 
头文字D 导演: 刘伟强; 麦兆辉; 
忠爱无言 导演: 谈宜之; 
宝贝老板2 导演: 汤姆·麦格拉思; 
神童 导演: 尼古拉斯·麦卡锡; 
陵水谣 导演: 江流; 
与神同行2：因与缘 导演: 金容华; 
怒火 导演: 陈木胜; 
龙之谷：破晓奇兵 导演: 宋岳峰; 
消失爱人 导演: 黄真真; 
夏目友人帐 第六季 特别篇 铃响的残株 导演: 大森贵弘; 出合小都美; 
海上钢琴师 导演: 朱塞佩·托纳多雷; 
哆啦A梦：大雄的南极冰冰凉大冒险 导演: 高桥敦史; 
熊出没之熊心归来 导演: 丁亮; 林永长; 
全民目击 导演: 非行; 
忍者神龟3 导演: 暂无
喜欢·你 导演: 许宏宇; 
修女 导演: 科林·哈迪; 
攻壳机动队 导演: 鲁伯特·桑德斯; 
阿凡达：创建潘多拉世界 导演: ThomasC.Grane; 
色，戒 导演: 李安; 
正义联盟：正义之心 Justice League: Heart of Justice 导演: 暂无
名侦探柯南的推理教室：深海的鉴定 导演: 暂无
前任女孩 导演: 朗·霍华德; 
当我们活着 导演: 迈赫迪·阿瓦兹; 
东北往事2 导演: 郭大雷; 
教父 导演: 弗朗西斯·福特·科波拉; 
厕所英雄 导演: 什里·那拉扬·辛; 
唐伯虎点秋香2019 导演: 张敏; 
南极之恋 导演: 吴有音; 
我身体里的那个家伙 导演: 姜孝镇; 
宠物小精灵：超梦的逆袭 导演: 迈克尔·海格尼; 汤山邦彦; 
疯狂外星人 导演: 暂无
快乐星球之三十六号 导演: 张惠民; 
水形物语 导演: 吉尔莫·德尔·托罗; 
捉妖记3 导演: 许诚毅; 
功夫熊猫4 导演: 吕寅荣; 
假面骑士平成世代 Dr.吃豆人对Ex-Aid&Ghost with传说骑士 导演: 坂本浩一; 
完美陌生人 导演: 保罗·杰诺维塞; 
敦刻尔克 导演: 克里斯托弗·诺兰; 
天·火 导演: 西蒙·韦斯特; 
疯狂原始人 导演: 柯克·德·米科; 克里斯·桑德斯; 
宝贝儿 导演: 刘杰; 
精灵怪物：疯狂之旅 导演: 霍尔格·塔佩; 
花木兰 导演: 艾利克斯·格雷夫斯; 
龙牌之谜 导演: 特鲁辛; 伊哥·斯坦普陈科; 
饥饿游戏3：嘲笑鸟（下） 导演: 弗朗西斯·劳伦斯; 
人间喜剧 导演: 韩曾光; 
废柴老爸 导演: 周伟; 冯超; 
火锅英雄 导演: 杨庆; 
我是传奇 导演: 弗朗西斯·劳伦斯; 
黑亚当 导演: 暂无
名侦探柯南：逃亡者·毛利小五郎 导演: 暂无
真·三国无双 导演: 周显扬; 
窃听风云4 导演: 尔冬升; 
九条命 导演: 巴里·索南菲尔德; 
生化危机2：启示录 导演: 亚历山大·维特; 
湮灭 导演: 亚历克斯·嘉兰; 
百鸟朝凤 导演: 吴天明; 
冰峰暴 导演: 余非; 
测谎人 导演: 暂无
恐怖电影 导演: EffremJ.Adams; 
新木乃伊 导演: 艾里克斯·库兹曼; 
憨豆特工 导演: 彼得·休伊特; 
机动战士高达 雷霆宙域 BANDIT FLOWER 导演: 松尾衡; 
王牌保镖 导演: 帕特里克·休斯; 杰夫·瓦德洛; 
叶问 导演: 叶伟信; 
误杀瞒天记 导演: 尼西卡特·卡马特; 
我的一级兄弟 导演: 陆相孝; 
大路朝天 导演: 苗月; 
电影 Smile 光之美少女! 儿童图画书里的世界都不协调！ 导演: 黑田成美; 
加勒比海盗2：聚魂棺 导演: 戈尔·维宾斯基; 
哥谭 第一季 导演: 弗朗西斯·劳伦斯; 德莫特·唐斯; 
刀剑神域：序列之争 导演: 伊藤智彦; 
大约在冬季 导演: 王维明; 
猩球崛起2：黎明之战 导演: 马特·里夫斯; 
请叫我英雄 导演: 佐藤信介; 
手机2 导演: 冯小刚; 
六人：泰坦尼克号上的中国幸存者 导演: 罗飞; 
谎话连篇 导演: 武正晴; 
冰封侠:时空行者 导演: 叶伟民; 
赛尔号大电影6：圣者无敌 导演: 王章俊; 
鬼娃回魂 导演: 暂无
生化危机 导演: 保罗·安德森; 
无主之作 导演: 弗洛里安·亨克尔·冯·多纳斯马尔克; 
小鞋子 导演: 马基德·马基迪; 
美国队长 导演: 阿尔伯特·派恩; KittyChalmers; 
S4侠降魔记 导演: 李克龙; 
追凶者也 导演: 曹保平; 
哈利·波特与阿兹卡班的囚徒 导演: 阿方索·卡隆; 
谁先爱上他的 导演: 徐誉庭; 许智彦; 
杰森·斯坦森未定名计划 导演: 科特·维莫; 
午夜凶铃 导演: 中田秀夫; 
剧场版 吹响！上低音号～誓言的终章～ 导演: 石原立也; 
集结号 导演: 冯小刚; 
追龙 导演: 金亨; 
5号停机坪 导演: 钱升玮; 
初恋的滋味 导演: 关尔; 
再见，嘴唇 导演: 盐田明彦; 
海贼王：伟大航路之争 导演: 暂无
飞跃部落格 导演: 王迅; 
纹身：西部纵横 导演: 陆一铜; 
求求你爱上我 导演: 董春泽; 
养家之人 导演: 诺拉·托梅; 
雪之华 导演: 桥本光二郎; 
鬼吹灯之巫峡棺山 导演: 卫立洲; 
在地下城寻求邂逅是否搞错了什么：俄里翁之箭 导演: 暂无
3096天 导演: 雪莉·霍曼; 
长江七号 导演: 周星驰; 
京城81号2 导演: 钱人豪; 
机械师2：复活 导演: 丹尼斯·甘塞尔; 
爸爸妈妈我爱你 导演: 崔守杰; 
超人之死 导演: 刘山姆; 杰克·卡斯托雷纳; 
黑寡妇巢 导演: AlanColberg; 
熔炉 导演: 黄东赫; 
银翼杀手2049 导演: 丹尼斯·维伦纽瓦; 
致青春·原来你还在这里 导演: 周拓如; 
康斯坦丁：地狱神探 导演: 弗朗西斯·劳伦斯; 
念念手纪 导演: 月川翔; 
孤儿怨 导演: 佐米·希尔拉; 
鹰眼 导演: 暂无
心理罪 导演: 谢东燊; 
我的世界 导演: PaulOwens; 
电锯惊魂8：竖锯 导演: 迈克尔·斯派瑞; 彼得·斯派瑞; 
恋恋笔记本 导演: 尼克·卡萨维茨; 
热带往事 导演: 温仕培; 
我唾弃你的坟墓：似曾相识 导演: 梅尔·扎奇; 
大汉十三将之血战疏勒城 导演: 回宇; 
海贼王特别篇：强者世界前传 导演: 暂无
末日崩塌 导演: 布拉德·佩顿; 
小美人鱼 导演: 丽贝卡·托马斯; 
死寂 导演: 温子仁; 
小黄人大眼萌2 导演: 布拉德·埃布尔森; 凯尔·巴尔达; 
钟馗诛妖传 导演: 暂无
超能失控 导演: 乔什·特兰克; 
超能失控 导演: 乔什·特兰克; 
篮球冠军 导演: 哈维尔·费舍尔; 
后天 导演: 罗兰·艾默里奇; 
机械师3 导演: 暂无
俑之城 导演: 丁亮; 林汇达; 
全球风暴 导演: 迪安·德夫林; 
叶问2：宗师传奇 导演: 叶伟信; 
伟大的愿望 导演: 南大钟; 
黑子的篮球·终极一战 导演: 多田俊介; 
海边的曼彻斯特 导演: 肯尼斯·罗纳根; 
今夜在浪漫剧场 导演: 武内英树; 
真相漩涡 导演: 西蒙·凯瑟; 
德鲁大叔 导演: 凯里·欧文; 
难以置信 导演: 陆小雅; 
侏罗纪公园2：失落的世界 导演: 史蒂文·斯皮尔伯格; 
名侦探柯南：业火的向日葵 导演: 静野孔文; 
禁地之恐怖医院 导演: 暂无
如珠如宝的人生 导演: 林敏骢; 麦启光; 
异星觉醒 导演: 丹尼尔·伊斯皮诺萨; 
致命毒液 导演: GaryBreslin; 
金牌 导演: 里马·卡蒂; 
破·局 导演: 连奕琦; 
假面骑士W(Double) FOREVER AtoZ/命运的盖亚记忆存储条 导演: 坂本浩一; 
你还记得那个少年么？ 导演: 暂无
冰川时代5：星际碰撞 导演: 麦克·特米尔; 加仑·T·楚; 
我的世界：菜鸟历险记 导演: 暂无
一路逆风 导演: 尼克·维克汉姆; 
邪恶变种地狱食肉类人僵尸活死人之侵袭恐怖报复重返新娘的儿子的黎明的一天的夜晚第三部 导演: JamesRiffel; 
战斗民族养成记 导演: 阿卡季·萨赫拉什维利; 夏昊; 
哈利·波特禁忌之旅 导演: 暂无
帕丁顿熊2 导演: 保罗·金; 
动物世界3 导演: 暂无
地球上的星星 导演: 阿米尔·汗; 阿莫尔·古普特; 
花椒之味 导演: 麦曦茵; 
天才少女 导演: 马克·韦布; 
卧虎藏龙 导演: 李安; 
破门 导演: 徐耿; 
铁甲钢拳2 导演: 暂无
摆渡人 导演: 张嘉佳; 
青蛇 导演: 徐克; 
全民超人汉考克2 导演: 暂无
功夫联盟 导演: 刘镇伟; 
了不起的盖茨比 导演: 巴兹·鲁赫曼; 
至暗时刻 导演: 乔·赖特; 
三日刺杀 导演: 约瑟夫·麦克金提·尼彻; 
遇见你真好 导演: 顾长卫; 
激战 导演: 林超贤; 
辛德勒的名单 导演: 史蒂文·斯皮尔伯格; 
T-34坦克 导演: 阿列克赛·西多洛夫; 
吹哨人 导演: 薛晓路; 
死寂 导演: 约翰·R·莱昂耐迪; 
英伦对决 导演: 马丁·坎贝尔; 
欢乐好声音 导演: 加斯·詹宁斯; 克里斯托夫·卢尔德莱; 
哈利·波特与死亡圣器（上) 导演: 大卫·叶茨; 
涨停板 导演: 暂无
妖铃铃 导演: 吴君如; 
第一滴血4 导演: 西尔维斯特·史泰龙; 
哥斯拉 导演: 本多猪四郎; 本田博太郎; 
少女宿舍 导演: 杨盼盼; 曹尚水; 
分裂 导演: M·奈特·沙马兰; 
夏目友人帐：猫咪老师首次变身使者 导演: 大森贵弘; 
乐高蝙蝠侠大电影 导演: 克里斯·麦凯; 
西西里的美丽传说 导演: 朱塞佩·托纳多雷; 
三少爷的剑 导演: 尔冬升; 
007：大破天幕杀机 导演: 萨姆·门德斯; 
绿毛怪格林奇 导演: 亚罗·切尼; 斯科特·摩西尔; 
乐高幻影忍者大电影 导演: 查理·宾; 鲍勃·罗根; 
超人总动员 导演: 布拉德·伯德; 
生化危机4：战神再生 导演: 保罗·安德森; 
十二金刚2：再次出击 导演: 安德鲁·麦克拉格伦; 
萌宠特工队 导演: 沃尔夫冈·劳恩斯坦; 克里斯托弗·劳恩斯坦; 
我们 导演: 乔丹·皮尔; 
哆啦A梦：新·大雄的日本诞生 导演: 八锹新之介; 
无极 导演: 陈凯歌; 
西游记之三借芭蕉扇 导演: 郑保瑞; 
铤而走险 导演: 甘剑宇; 
狄仁杰之通天帝国 导演: 徐克; 
铁甲钢拳 导演: 肖恩·利维; 
金蝉脱壳2：冥府 导演: 史蒂芬·C·米勒; 
捷德奥特曼 剧场版：连接吧！心愿！！ 导演: 坂本浩一; 
诗眼倦天涯 导演: 徐浩峰; 
言叶之庭 导演: 新海诚; 
电影痴汉 导演: 徐梓耀; 
东北古惑仔之长春往事 导演: 暂无
乐高大电影 导演: 克里斯托弗·米勒; 菲尔·罗德; 
妈妈的朋友 导演: 暂无
绣春刀3 导演: 路阳; 
功夫熊猫 导演: 马克·奥斯本; 约翰·斯蒂文森; 
头脑特工队 导演: 彼特·道格特; 罗纳尔多·德尔·卡门; 
失恋33天 导演: 滕华涛; 
失恋33天 导演: 滕华涛; 
游戏世界：绝地求生 导演: 陆春伟; 
危城 导演: 陈木胜; 
来自深渊：流浪的黄昏 导演: 小岛正幸; 
绝世高手 导演: 卢正雨; 
灵偶契约 导演: 威廉·布伦特·贝尔; 
巨石强森和Siri：事事在握 导演: 暂无
OK la 相遇五月天 导演: 暂无
蜘蛛侠：迷失复仇者 导演: 暂无
如影随形 导演: MikaTervonen; 
水果硬糖 导演: 大卫·斯雷德; 
血战湘江 导演: 陈力; 
复仇者 导演: 杰西·约翰逊; 
龙门飞甲 导演: 徐克; 张之亮; 
遇见你之前 导演: 西娅·夏罗克; 
超人归来 导演: 布莱恩·辛格; 
碟中谍 导演: 布莱恩·德·帕尔玛; 
十三猎杀 导演: 暂无
南哥 导演: 郑华; 潘钧; 
燕赤霞猎妖传 导演: 王凯; 
为美好的世界献上祝福！红传说 导演: 金崎贵臣; 
美国队长：电视电影2 导演: 伊凡·纳吉; 
碟中谍4 导演: 布拉德·伯德; 
世上只有爸爸好 导演: 袁杰; 
寂静之地2 导演: 约翰·卡拉辛斯基; 
楚门的世界 导演: 彼得·威尔; 
哥斯拉：决战之都 导演: 静野孔文; 濑下宽之; 
哈利·波特与凤凰社 导演: 大卫·叶茨; 
速度与激战 导演: 罗恩·桑顿; 
恶棍天使 导演: 邓超; 俞白眉; 
检查方的罪人 导演: 原田真人; 
猩球崛起 导演: 鲁伯特·瓦耶特; 
僵尸 导演: 麦浚龙; 
嘉年华 导演: 文晏; 
无以为家 导演: 暂无
人间喜剧 导演: 陈庆嘉; 秦小珍; 
战龙哥斯拉之三大怪兽 导演: 本多猪四郎; 
拯救地球 导演: 暂无
花样年华 导演: 王家卫; 
似水流年 导演: 郑君奇; 李龙俊; 
暮光之城4：破晓（下） 导演: 比尔·康顿; 
神战：权力之眼 导演: 亚历克斯·普罗亚斯; 
刺客信条 导演: 贾斯汀·库泽尔; 
一生一世 导演: 邹佡; 
小鬼乃酷 导演: 暂无
我的英雄学院 OAD1 解救！救援训练！ 导演: 长崎健司; 
诡魔童 导演: 布拉德·佩顿; 
0.0兆赫 导演: 刘善东; 
英雄联盟：新的曙光 导演: 暂无
毒液疗法 导演: 暂无
逃出绝命镇 导演: 乔丹·皮尔; 
恐怖浴室 导演: 陆诗雨; 
角头3 导演: 暂无
那些年，我们一起追的女孩 导演: 长谷川康夫; 
破战 导演: 彭发; 
西风烈 导演: 高群书; 
睡在我上铺的兄弟 导演: 张琦; 
多啦A梦族：奇怪的点心娜娜王国 导演: 米谷良知; 
0与1的诱惑 导演: WallyWhite; 
碟仙实录 导演: 程中豪; 王凯; 
飞鸽特工队 导演: 尼克·布鲁诺; 
Re：从零开始的异世界生活 Memory Snow 导演: 暂无
儿童警察 电影版 导演: 福田雄一; 
路边野餐 导演: 毕赣; 
的士速递5 导演: 弗兰克·盖思堂彼得; 
新僵尸先生 导演: 刘观伟; 
普罗米修斯 导演: 雷德利·斯科特; 
失控·幽灵飞车 导演: 林韬; 阿克塞尔·塞德; 
起风了 导演: 宫崎骏; 
钢铁飞龙之再见奥特曼 导演: 王巍; 
时间规划局 导演: 安德鲁·尼科尔; 
蜘蛛人 导演: 暂无
超凡战队 导演: 迪恩·以色列特; 
二代妖精之今生有幸 导演: 肖洋; 
21克拉 导演: 何念; 
法医秦明之车尾游魂 导演: 卫立洲; 
中邪 导演: 马凯; 
五十度灰 导演: 萨姆·泰勒·约翰逊; 
刀背藏身 导演: 徐浩峰; 
横财局中局 导演: 陈建勇; 
移动迷宫 导演: 韦斯·鲍尔; 
黑客帝国2：重装上阵 导演: 莉莉·沃卓斯基; 拉娜·沃卓斯基; 
翠丝 导演: 李骏硕; 
无敌浩克之死 导演: 比尔·贝克比; 
齐天大圣之真假孙悟空 导演: 暂无
终结者2：审判日 导演: 詹姆斯·卡梅隆; 
小时代3：刺金时代 导演: 郭敬明; 
被解救的姜戈 导演: 昆汀·塔伦蒂诺; 
沙龙：以色列的钢铁侠 导演: JohnThynne; 
巧虎电影：巧虎的彩虹绿洲 导演: IsamuHirabayashi; 
神偷奶爸2 导演: 皮埃尔·柯芬; 克里斯·雷纳德; 
黑衣人重启版1 导演: 暂无
小马宝莉大电影 导演: 杰森·西森; 
杀破狼 导演: 叶伟信; 
逆时营救 导演: 尹鸿承; 
奇门遁甲 导演: 袁和平; 
垫底联盟 导演: 王文; 
壮志凌云2：马弗里克 导演: 约瑟夫·科辛斯基; 
燃点 导演: 关琇; 萧屺楠; 
星球大战2：帝国反击战 导演: 厄文·克什纳; 
猛鬼吹灯之寻龙决 导演: 暂无
骷髅岛：金刚之血 导演: 尼尔·马歇尔; 
阿里巴巴三根金发 导演: 蒋叶峰; 
钢铁战侠 导演: BrettKelly; 
反转人生 导演: 伍仕贤; 
天作谜案 导演: 阿沛·乔普拉; 
星际探索 导演: 詹姆斯·格雷; 
比海更深 导演: 是枝裕和; 
玩具总动员 导演: 约翰·拉塞特; 
黑客帝国3：矩阵革命 导演: 莉莉·沃卓斯基; 拉娜·沃卓斯基; 
分手合约 导演: 吴基焕; 
绝地逃亡 导演: 雷尼·哈林; 
花小楼之捣浆糊 导演: 谢汉阳; 吴勋; 
小丑 导演: KalinadeMoura; 
哈利·波特与密室 导演: 克里斯·哥伦布; 
九品芝麻官 导演: 王晶; 
红花绿叶 导演: 刘苗苗; 胡维捷; 
树大招风 导演: 许学文; 欧文杰; 
芭比之长发公主 导演: 欧文·赫利; 
谍影重重5 导演: 保罗·格林格拉斯; 
极盗车神 导演: 埃德加·赖特; 
毕业旅行之逍遥骑士 导演: 郭奎永; 
小鬼当家 导演: 克里斯·哥伦布; 
两只老虎 导演: 李非; 
幼女战记 剧场版 导演: 暂无
白蛇传说 导演: 程小东; 
闺蜜2 导演: 黄真真; 
不老奇事 导演: 徐超; 
迪迦奥特曼外传 远古复苏的巨人 导演: 圆谷一夫; 高野宏一; 
北京国家大剧院歌剧演出现场版 导演: 滕俊杰; 
银河守卫队 导演: 杰瑞卡·克莱兰; 凯文·芒罗; 
狂赌之渊 电影版 导演: 英勉; 
降临 导演: 丹尼斯·维伦纽瓦; 
海洋深处 导演: 朗·霍华德; 
昆仑兄弟 导演: 阿布都克里木·阿不力孜; 姜宏; 
荒野猎人 导演: 亚利桑德罗·冈萨雷斯·伊纳里图; 
电锯惊魂 导演: 温子仁; 
妈妈的爱 导演: 暂无
大护法 导演: 不思凡; 
导盲犬小Q 导演: 崔洋一; 
太极 导演: 周星驰; 
爱丽丝梦游仙境 导演: 蒂姆·波顿; 
与恐龙同行 导演: NeilNightingale; 巴里·库克; 
中国合伙人2 导演: 刘亚当; 
正义联盟：亚特兰蒂斯的宝座 导演: 伊桑·斯波尔丁; 杰伊·欧力瓦; 
安娜贝尔2：诞生 导演: 大卫·F·桑德伯格; 
碟中谍3 导演: J·J·艾布拉姆斯; 
未定名超人电影 导演: 暂无
敢死队2 导演: 西蒙·韦斯特; 
喜羊羊与灰太狼之牛气冲天 导演: 赵崇邦; 
赤红热血 导演: 杨博; 
托马斯大电影之了不起的比赛 导演: 大卫·斯特登; 
解救吾先生 导演: 丁晟; 
疯狂原始人2 导演: 克里斯·桑德斯; 柯克·德·米科; 
终结者3 导演: 乔纳森·莫斯托; 
灵魂摆渡之风华绝代 导演: 巨兴茂; 
夜半歌声 导演: 于仁泰; 
陆垚知马俐 导演: 文章; 
北京遇上西雅图之不二情书 导演: 薛晓路; 
恶人传 导演: 李元泰; 
007：大战皇家赌场 导演: 马丁·坎贝尔; 
名侦探柯南：深蓝色的海盗旗 导演: 山本泰一郎; 
邻座的怪同学OAD：邻座的极道同学 导演: 镝木宏; 
摘金奇缘 导演: 朱浩伟; 
禁闭岛 导演: 马丁·斯科塞斯; 
电锯惊魂7 导演: 凯文·格劳特; 
春光乍泄 导演: 王家卫; 
生化危机3：灭绝 导演: 拉塞尔·穆卡希; 
7号房的礼物 导演: 李焕庆; 
蝙蝠侠 导演: 蒂姆·波顿; 
冰河追凶 导演: 徐伟; 
逆战 导演: 林超贤; 
查理和巧克力工厂 导演: 蒂姆·波顿; 
飞屋环游记 导演: 彼特·道格特; 鲍勃·彼德森; 
星球大战前传2：克隆人的进攻 导演: 乔治·卢卡斯; 
狄仁杰之无头神将 导演: 暂无
春娇救志明 导演: 彭浩翔; 
我是哪吒 导演: 舒展; 
滚动的钢蛋 导演: 李春啸; 
枪炮腰花 导演: 张猛; 
日常幻想指南 导演: 梁栋; 
六月的秘密 导演: 王暘; 
超龙珠Z 导演: 暂无
低压槽：欲望之城 导演: 张家辉; 
无间道3：终极无间 导演: 刘伟强; 麦兆辉; 
永无止境 导演: 尼尔·博格; 
狮子王3 导演: 布拉德利·雷蒙德; 
那山那人那狗 导演: 霍建起; 
代号8 导演: JeffChan; 
宙斯之子：赫拉克勒斯 导演: 布莱特·拉特纳; 
V字仇杀队 导演: 詹姆斯·麦克特格; 
鲁邦三世VS名侦探柯南 剧场版 导演: 龟垣一; 
艺伎回忆录 导演: 罗伯·马歇尔; 
海底总动员2：多莉去哪儿 导演: 安德鲁·斯坦顿; 安格斯·麦克莱恩; 
碟中谍2 导演: 吴宇森; 
奔跑吧！兄弟 导演: 胡笳; 岑俊义; 
移动迷宫2 导演: 韦斯·鲍尔; 
活着 导演: 张艺谋; 
电影大亨之横店风云 导演: 暂无
阿凡提之奇缘历险 导演: 刘炜; 
夜伴歌声 导演: 陆诗雷; 
纳尼亚传奇：狮子、女巫和魔衣橱 导演: 安德鲁·亚当森; 
李雷和韩梅梅——昨日重现 导演: 杨永春; 
传奇的诞生 导演: 杰夫·泽姆巴利斯特; 迈克尔·泽姆巴利斯特; 
微微一笑很倾城 导演: 赵天宇; 
名侦探柯南：沉默的15分钟 导演: 山本泰一郎; 静野孔文; 
秒速5厘米 导演: 新海诚; 
举起手来！ 导演: 冯小宁; 
超级战舰 导演: 彼得·博格; 
致我们终将到来的爱情 导演: 郑来志; 
碟中谍8 导演: 克里斯托弗·麦奎里; 
大闹东海 导演: 刘镇伟; 
守法公民 导演: F·加里·格雷; 
限期破案 导演: 刘浩良; 
未定名史泰龙恐怖片项目 导演: 吉姆·米可; 
皮绳上的魂 导演: 张杨; 
鸟人 导演: 亚利桑德罗·冈萨雷斯·伊纳里图; 
模仿游戏 导演: 莫滕·泰杜姆; 
极线杀手 导演: 乔纳斯·阿克伦德; 
逆流大叔 导演: 陈咏燊; 
陀地驱魔人 导演: 张家辉; 
功夫3D 导演: 周星驰; 
他是龙 导演: 因达尔·詹杜巴耶夫; 
22年后的自白 导演: 入江悠; 
幸福额度 导演: 陈正道; 
美国队长：电视电影 导演: 罗德·霍尔卡穆; 
王牌逗王牌 导演: 王晶; 
深海历险记 导演: 胡里奥·索托·古尔皮德; 陈红; 
寂静岭 导演: 克里斯多夫·甘斯; 
未知死亡 导演: A.R.目虏古多斯; A·R·拉曼; 
低俗小说 导演: 昆汀·塔伦蒂诺; 
比得兔 导演: 威尔·古勒; 
徒手攀岩 导演: 金国威; 伊丽莎白·柴·瓦沙瑞莉; 
无人生还 导演: 莫滕·泰杜姆; 
大灌篮 导演: 朱延平; 
剑雨 导演: 苏照彬; 吴宇森; 
旅猫日记 导演: 三木康一郎; 
欢迎来到旧金山 导演: 孙艳杰; 
三国杀·幻 导演: 吕柯憬; 
魔兽世界：德拉诺之王 导演: MarcMessenger; 
星际迷航 导演: J·J·艾布拉姆斯; 
巴霍巴利王：开端 导演: S·S·拉贾穆里; 
一天 导演: 罗勒·莎菲; 
新神奇四侠2 导演: 暂无
当我们在一起 导演: 张爵西; 
贫民窟的百万富翁 导演: 丹尼·博伊尔; 洛芙琳·坦丹; 
雷神 导演: 乌斯曼·塞姆班; 
蜡笔小新：宇宙人来袭 导演: 桥本昌和; 
星球大战3：绝地归来 导演: 理查德·马昆德; 
蝙蝠侠：夜神飞驰 导演: MichaelD.Black; 
德州巴黎 导演: 维姆·文德斯; 
心灵传输者 导演: 道格·里曼; 
最后的勇士 导演: TimothyHussin; 
阿尔法：狼伴归途 导演: 艾尔伯特·休斯; 
八爪狂鲨大战梭鱼翼龙 导演: KevinO'Neill; 
德云社丁酉年封箱庆典2018 导演: 暂无
灰姑娘 导演: 肯尼思·布拉纳; 
龙珠Z：神与神 导演: 细田雅弘; 
人兽杂交 导演: 文森佐·纳塔利; 
不二神探 导演: 王子鸣; 
Hello 北京 导演: 万剑英; 
安娜 导演: 吕克·贝松; 
双生 导演: 暂无
蜘蛛侠：秘密战争 导演: BobRichardson; 
三生三世十里桃花2 导演: 赵小丁; 林玉芬; 
珍珠港 导演: 迈克尔·贝; MichaelRosenfeld; 
十吨刺客 导演: 刘镇伟; 
夏有乔木 雅望天堂 导演: 赵真奎; 
色欲中环 导演: 暂无
魔法学院 导演: 暂无
生活万岁 导演: 程工; 任长箴; 
冰雪女王3：火与冰 导演: 阿列克谢·特斯蒂斯林; 
丧尸乐园2 导演: 鲁本·弗雷斯彻; 
升级 导演: 雷·沃纳尔; 
熊出没之过年 导演: 刘富源; 丁亮; 
邹碧华 导演: 王兴东; 田水泉; 
银魂 真人版 导演: 福田雄一; 
钢琴家 导演: 罗曼·波兰斯基; 
2001太空漫游 导演: 斯坦利·库布里克; 
神奇宝贝：皮卡丘的冰之大冒险 导演: 暂无
海蒂 导演: PaulMarcus; 
春娇与志明 导演: 彭浩翔; 
我为车狂 导演: 殷国君; 
悲惨世界 导演: 汤姆·霍珀; 
五十米之恋 导演: 李依理; 
火箭少女101飞行演唱会*广州站 导演: 暂无
私人订制 导演: 冯小刚; 
星球大战：波巴·费特外传 导演: 暂无
唐伯虎点秋香 导演: 李力持; 
死侍2教你湿画法 导演: 暂无
名侦探柯南：贝克街的亡灵 导演: 儿玉兼嗣; 
半镜 导演: 杜天甫; 
嫌疑人X的献身 导演: 西谷弘; 
虎胆追凶 导演: 伊莱·罗斯; 
导火线 导演: 叶伟信; 
红衣小女孩2 导演: 程伟豪; 
无敌钢铁侠 导演: PatrickArchibald; FrankPaur; 
浪矢解忧杂货店 导演: 广木隆一; 
新大头儿子和小头爸爸 除夕·白夜城 导演: 暂无
垫底辣妹 导演: 土井裕泰; 
博物馆奇妙夜3 导演: 肖恩·利维; 
若能与你乘风破浪 导演: 汤浅政明; 
叱咤风云 导演: 陈奕先; 
怪物史莱克 4D 导演: 西蒙·J·史密斯; 
绿光 导演: 埃里克·侯麦; 
午夜整容室 导演: 曹志鹏; 
蝙蝠侠：致命玩笑 导演: 刘山姆; 
英雄本色2018 导演: 丁晟; 
送我上青云 导演: 滕丛丛; 
大闹西游 导演: 马系海; 
大鳄魔 导演: 妮娜·列提; 
李宗盛：理性与感性作品音乐会 导演: 暂无
三级：史上最伟大的成人电影 导演: EliCross; 
繁花 导演: 王家卫; 
玩具总动员：遗忘的时光 导演: 史蒂夫·波赛尔; 
假面骑士EX-AID 秘技 超战斗DVD 假面骑士Lazer 导演: 铃村展弘; 
青春派 导演: 刘杰; 
深红累之渊 导演: 佐藤祐市; 
教授与疯子 导演: 法尔哈德·撒夫尼亚; 
第一滴血 导演: 特德·科特切夫; 
罗曼蒂克消亡史 导演: 程耳; 
饥饿游戏 导演: 盖瑞·罗斯; 
我的日记 导演: 成龙; 
悬崖 导演: 韩志; 
少林足球 导演: 周星驰; 
断背山 导演: 李安; 
朋友妈妈: 年轻的母亲 导演: 暂无
香山之春 导演: 宁海强; 
汪峰鸟巢演唱会 2014 导演: 暂无
生门 导演: 陈为军; 
生门 导演: 陈为军; 
哈利·波特与火焰杯 导演: 迈克·内威尔; 
人体蚁穴 导演: BillZebub; 
云图 导演: 莉莉·沃卓斯基; 拉娜·沃卓斯基; 
谍狼之变色龙 导演: 尹哲; 
白雪公主和七个小矮人 导演: 戴维·汉德; 威廉·科特雷尔; 
门徒 导演: 尔冬升; 
古董局中局 导演: 郭子健; 
夏天19岁的肖像 导演: 张荣吉; 
萨利机长 导演: 克林特·伊斯特伍德; 
哈利·波特与混血王子 导演: 大卫·叶茨; 
美国往事 导演: 赛尔乔·莱翁内; 
龙拳小子 导演: 陶声; 王韦程; 
毒。诫 导演: 刘国昌; 
铠甲勇士捕王 导演: 郑国伟; 朴英均; 
马戏之王2 导演: 迈克尔·格雷西; 
迪迦奥特曼：最终圣战 导演: 圆谷一夫; 村石宏实; 
露水红颜 导演: 高希希; 
疯狂丑小鸭 导演: 郑成峰; 蒋叶峰; 
本杰明·巴顿奇事 导演: 大卫·芬奇; 
狼少年 导演: 赵圣熙; 
咒怨2 导演: 清水崇; 
熊出没注意 导演: 程樯; 
杀死比尔 导演: 昆汀·塔伦蒂诺; 
天注定 导演: 贾樟柯; 
老爸102岁 导演: 奥米史·舒克拉; 
一吻定情电影版1：高中篇 导演: 暂无
魔发奇缘 导演: 拜伦·霍华德; 内森·格雷诺; 
舞出我人生6 导演: 袁文忠; 
我是山姆 导演: 杰茜·尼尔森; 
南京！南京！ 导演: 陆川; 
舞出我人生6 导演: 袁文忠; 
万万没想到 导演: 易小星; 
机械师 导演: 西蒙·韦斯特; 
蜡笔小新：梦境世界大突击 导演: 高桥涉; 
猫鼠游戏 导演: 史蒂文·斯皮尔伯格; 
比利·林恩的中场战事 导演: 李安; 
飓风营救 导演: 皮埃尔·莫瑞尔; 
泄密者 导演: 邱礼涛; 
全城戒备 导演: 陈木胜; 
海绵宝宝 导演: 保罗·蒂贝特; 保罗·提比特; 
一百年很长吗 导演: 萧寒; 
画皮2 导演: 乌尔善; 
彗星来的那一夜 导演: 詹姆斯·沃德·布柯特; 
房间 导演: 伦尼·阿伯拉罕森; 
秘果 导演: 连奕琦; 
泰味儿 导演: 温德光; 郑培锋; 
林中小屋 导演: 德鲁·高达; 
古井凶灵 导演: 王辰六; 
妈妈咪鸭 导演: 赵锐; 克里斯·詹金斯; 
从零开始 导演: AanandL.Rai; 
闻香识女人 导演: 马丁·布莱斯特; 
紫罗兰永恒花园 外传 导演: 暂无
重返·狼群 导演: 亦风; 
驯兔记 导演: 陈静; 
致命魔术 导演: 克里斯托弗·诺兰; 
保姆日记 导演: 莎里·斯宾厄·伯曼; 罗伯特·帕西尼; 
无敌破坏王 导演: 瑞奇·摩尔; 
黄沙战神 导演: BoyapatiSrinu; 
通缉令 导演: 提莫·贝克曼贝托夫; 
一步之遥 导演: 姜文; 林佳俊; 
死神来了5 导演: 史蒂文·奎里; 
乐高大电影4 导演: 暂无
纽约唐人街碎尸案 导演: 胡鹏; 伍锦霞; 
魔法雪怪 导演: 弗兰齐丝卡·布赫; 
赤壁（上） 导演: 吴宇森; 
风声 导演: 高群书; 陈国富; 
迪迦奥特曼～光的孩子们～ 导演: 暂无
东京食尸鬼 真人版2 导演: 萩原健太郎; 
午夜凶铃2：贞子缠身 导演: 中田秀夫; 
请以你的名字呼唤我续集 导演: 卢卡·瓜达尼诺; 
海贼王3D电影版：追寻草帽 导演: 佐藤宏幸; 
老无所依 导演: 伊桑·科恩; 乔尔·科恩; 
终极斗士4 导演: 艾萨克·佛罗伦汀; 托多尔·查卡诺威; 
犬之岛 导演: 韦斯·安德森; 
一秒钟 导演: 张艺谋; 
择天记大电影 导演: 暂无
木乃伊3 导演: 罗伯·科恩; 
七月之后 导演: 连子; 
八佰棒 导演: KevinFengKe; 
告白 导演: 中岛哲也; 
毒战 导演: 李海暎; 
老公去哪了 导演: 李思易; 
小飞象60周年限量版 导演: ClareBaren; 
蚯蚓 导演: 尹学烈; 
笔仙大战贞子 导演: 黄河; 
神话 导演: 唐季礼; 
家和万事惊 导演: 邱礼涛; 
机器人总动员 导演: 安德鲁·斯坦顿; 
你好，疯子！ 导演: 饶晓志; 
生生 导演: 安邦; 
火影忍者剧场版：终章 导演: 小林常夫; 
神奇动物在哪里5 导演: 大卫·叶茨; 
3D肉蒲团之极乐宝鉴 导演: 孙立基; 
名侦探柯南真人版2：工藤新一的复活 导演: 冈本浩一; 
杀人回忆 导演: 奉俊昊; 
越光宝盒 导演: 刘镇伟; 
英雄崛起 导演: 暂无
泰勒·斯威夫特：“举世盛名”巡回演唱会 导演: 保罗·达格代尔; 
沼泽怪物 导演: 弗雷德·安德鲁斯; 
十万个冷笑话2 导演: 卢恒宇; 李姝洁; 
美国队长 导演: 艾尔玛·克里夫顿; 约翰·昂格利什; 
边境杀手2：边境战士 导演: 斯特法诺·索利马; 
超级蜘蛛侠 导演: 暂无
潜伏2 导演: 温子仁; 
精灵旅社4 导演: 暂无
乒临城下 导演: 张洪; 赵明; 
独立日 导演: 罗兰·艾默里奇; 
潜伏4：锁命亡灵 导演: 亚当·罗比特尔; 
无耻混蛋 导演: 昆汀·塔伦蒂诺; 伊莱·罗斯; 
龙珠Z剧场版9：银河面临危机!! 身手不凡的高手!! 导演: 上田芳裕; 
海市蜃楼 导演: SvetozarRistovski; 
玩具熊的五夜后宫 导演: 克里斯·哥伦布; 
漫话美国队长：冬日战士 导演: 暂无
娑婆诃 导演: 张宰贤; 
鸭王 导演: 区焯文; 
摇摇晃晃的人间 导演: 范俭; 
漫威崛起：幽灵蜘蛛 导演: 暂无
血观音 导演: 杨雅喆; 
古剑奇谭之流月昭明 导演: 雷尼·哈林; 
十月围城 导演: 陈德森; 
漫威崛起：幽灵蜘蛛 导演: 暂无
特朗普：美国的下一任总统? 导演: 暂无
波希米亚狂想曲的故事 导演: CarlJohnston; 
星球大战前传1：幽灵的威胁 导演: 乔治·卢卡斯; 
骇客交锋 导演: 迈克尔·曼; 
萤火奇兵2：小虫不好惹 导演: 邓伟锋; 
异形大战铁血战士：救赎 导演: 暂无
普罗米修斯3 导演: 暂无
功夫熊猫2 导演: 吕寅荣; 
推拿 导演: 娄烨; 
苏丹 导演: 阿里·阿巴斯·札法; 
伦敦陷落 导演: 巴巴克·纳加非; 
窃听风云2 导演: 麦兆辉; 庄文强; 
暮光之城4：破晓（上） 导演: 比尔·康顿; 
魔神Z 导演: 志水淳儿; 
午夜场 导演: 暂无
长安道 导演: 李骏; 
大微商 导演: 李锐; 李锐; 
周恩来 导演: 丁荫楠; 
我们的爱情 导演: 汪小白; 
傲慢与偏见 导演: 乔·赖特; 
勇敢的心 导演: 梅尔·吉布森; 
穿普拉达的女王 导演: 大卫·弗兰科尔; 
梦想之城 导演: 刘抒鹃; 吴立晓; 
超胆侠 导演: 马克·斯蒂文·约翰逊; 
闯堂兔3囧囧时光机 导演: 曾宪林; 
惊声尖笑 导演: 基伦·埃弗瑞·韦恩斯; 
伸冤人2 导演: 安东尼·福奎阿; 
预告片创伤3：80年代恐怖马拉松 导演: 暂无
布达佩斯大饭店 导演: 韦斯·安德森; 
满城尽带黄金甲 导演: 张艺谋; 
山楂树之恋 导演: 张艺谋; 
古惑仔之人在江湖 导演: 刘伟强; 
溺水小刀 导演: 山户结希; 
虚拟形象 导演: 和田笃司; 
2015奇幻冰世界迪士尼《冰雪奇缘》特展 导演: 暂无
Ghost重生：假面骑士Specter 导演: 暂无
我唾弃你的坟墓 导演: 史蒂文·R·蒙若尔; 
卓别林 导演: 理查德·阿滕伯勒; 
梦想合伙人 导演: 张太维; 
画皮 导演: 陈嘉上; 钱永强; 
夺宝奇兵5 导演: 史蒂文·斯皮尔伯格; 
我唾弃你的坟墓2 导演: 史蒂文·R·蒙若尔; 
切尔诺贝利之春 导演: 小野败仔; 
狄仁杰之幻涅魔蛾 导演: 郭会中; 
秘不可言 导演: 曹勇; 曹涌; 
叶问：终极一战 导演: 邱礼涛; 
金蝉脱壳 导演: 米凯尔·哈弗斯特罗姆; 
蝙蝠侠：黑暗骑士归来（下） 导演: 杰伊·欧力瓦; 
京剧猫 导演: 暂无
潜行者 导演: 吕冠南; 谭广源; 
友谊地久天长 导演: 苏俊文; 
喵星人 导演: 陈木胜; 
不期而遇 导演: 陈卓; 
终结者 导演: 詹姆斯·卡梅隆; 
超人前传：绝对正义 导演: 汤姆·威灵; 
哥斯拉：大怪兽总攻击 导演: 金子修介; 
异能 导演: 保罗·麦奎根; 
鲨滩 导演: 佐米·希尔拉; 
京剧猫 导演: 暂无
邦德25 导演: 萨姆·门德斯; 丹尼·博伊尔; 
警告 导演: 丹尼尔·卡尔帕索罗; 
坑爹游戏 导演: 米宝; 
奥斯卡 导演: GuroEkornholmen; 
阿拉姜色 导演: 松太加; 
百万巨鳄 导演: 林黎胜; 
龙珠Z THE REAL 4D 导演: 暂无
我的英雄学院 第2季：英雄笔记 导演: 长崎健司; 
功夫梦2 导演: 布瑞克·埃斯纳尔; 哈罗德·兹瓦特; 
英雄 导演: 张艺谋; 
一九四二 导演: 冯小刚; 
提着心，吊着胆 导演: 李雨禾; 
罗宾汉：起源 导演: 奥图·巴瑟赫斯特; 
虐心之旅 导演: 伊峥; 
中国推销员 导演: 檀冰; 
金榜题名 导演: 李惠民; 
小时代2：青木时代 导演: 郭敬明; 
釜山行英文版 导演: 暂无
美丽心灵 导演: 朗·霍华德; 
哥斯拉之怪兽王复活 导演: 桥本幸治; R.J.Kizer; 
神秘家族 导演: 朴裕焕; 
速递与激情 导演: 暂无
玩具总动员2 导演: 约翰·拉塞特; 艾什·布兰农; 
金瓶梅2：爱的奴隶 导演: 钱文锜; 
花木兰2 导演: 达雷尔·鲁尼; 林恩·萨瑟兰; 
父子雄兵 导演: 袁卫东; 
侵入者 导演: 德翁·泰勒; 
喊·山 导演: 杨子; 
辛亥革命 导演: 成龙; 张黎; 
花木兰2 导演: 达雷尔·鲁尼; 林恩·萨瑟兰; 
再见少年 导演: 石鑫; 
好好活着 导演: 暂无
一级恐惧 导演: 格里高利·霍布里特; 
黑寡妇 导演: 纽纳利·约翰逊; 
黎明勋章 导演: 暂无
雄狮 导演: 加斯·戴维斯; 
古惑仔3之只手遮天 导演: 刘伟强; 
宠物小精灵：酋雷姆VS圣剑士凯尔迪奥 导演: 汤山邦彦; 
三人行 导演: 杜琪峰; 
我妈妈的朋友2 导演: 暂无
归来 导演: 张艺谋; 
死神来了 导演: 黄毅瑜; 
切腹 导演: 小林正树; 
杀生 导演: 管虎; 
铠甲勇士之雅塔莱斯 导演: 郑国伟; 
食人蚁军团 导演: 暂无
剧场版 泰罗奥特曼：燃烧! 奥特6兄弟 导演: 山际永三; 
名侦探柯南特典：新一与小兰·麻将牌与七夕的回忆 导演: 暂无
最后的棒棒 导演: 何苦; 
七宗罪 导演: 大卫·芬奇; 
北极 导演: 乔·佩那; 
四月是你的谎言 导演: 新城毅彦; 
猫与桃花源 导演: 王微; 
行骗天下 剧场版 导演: 田中亮; 
开国将帅授勋1955 导演: 唐国强; 
追风筝的人 导演: 马克·福斯特; 
单身男女2 导演: 杜琪峰; 麦启光; 
寻龙诀之黄金帝国 导演: 暂无
国王的演讲 导演: 汤姆·霍珀; 
国王的演讲 导演: 汤姆·霍珀; 
蝙蝠侠归来 导演: 蒂姆·波顿; 
坂本龙一：终曲 导演: 史蒂芬·野村·斯奇博; 
人生果实 导演: 伏原健之; 
杀手：代号47 导演: 泽维尔·吉恩斯; 
石破添惊 导演: 暂无
长官传奇 导演: 杨议; 
私人会所 导演: 暂无
丧尸未逝 导演: 吉姆·贾木许; 
决战食神 导演: 叶伟民; 
小狗奶瓶 导演: 彭力; 
西游记之真假美猴王 导演: 暂无
新澳门风云 导演: 王晶; 刘伟强; 
猎鹰 导演: 弗里德里克·索尔·弗里德里克松; 
暮光之城3：月食 导演: 大卫·斯雷德; 
新七龙珠 导演: 陈广鸿; LeungChung; 
熊出没的夏天 导演: 郑喜宁; 
误杀瞒天记 导演: 暂无
米花之味 导演: 鹏飞; 
喜羊羊与灰太狼之羊年喜羊羊 导演: 黄伟明; 
沉默的羔羊 导演: 乔纳森·戴米; 
人间喜剧 导演: 鸿鸿; 
神偷奶爸 导演: 克里斯·雷纳德; 皮埃尔·柯芬; 
木乃伊 导演: 斯蒂芬·索莫斯; 
恶霸警察 导演: 李桢凡; 
冰雪奇缘的故事：打造迪斯尼动画经典 导演: 鲁迪·贝德纳; 
乐高幻影忍者：武术大师 导演: 暂无
空中大灌篮2 导演: 林诣彬; 特伦斯·南斯; 
海洋奇缘 导演: 罗恩·克莱蒙兹; 约翰·马斯克; 
笑傲江湖2：东方不败 导演: 程小东; 唐季礼; 
有完没完 导演: 王啸坤; 
鸭王2 导演: 姜国民; 
一切如你 导演: 黄兆函; 傅绍杰; 
重返地球 导演: M·奈特·沙马兰; 
蓝精灵：寻找神秘村 导演: 凯利·阿斯博瑞; 
守护者：世纪战元 导演: 萨里·奥德赛耶; 
海贼王剧场版Z 导演: 长峰达也; 
东邪西毒：终极版 导演: 王家卫; 
阿里巴巴大盗奇兵 导演: 郑成峰; 
宝贝计划 导演: 陈木胜; 
寄居者 导演: 罗伯·科恩; 
一路爱情 导演: 陈晓曦; 
再见十八班 导演: 暂无
床下有人4：异能觉醒 导演: 牛朝阳; 
镰仓物语 导演: 山崎贵; 
海绵宝宝3 导演: 保罗·蒂贝特; 保罗·提比特; 
哆啦A梦：大雄与绿巨人传 导演: 渡边步; 
肆式青春 导演: 李豪凌; 易小星; 
合法伴侣 导演: 黄雷; 
旺角卡门 导演: 王家卫; 
此房是我造 导演: 拉斯·冯·提尔; 
神探大战 导演: 韦家辉; 
名师高徒 导演: 周阁; 
了不起的菲丽西 导演: 埃里克·韦林; 艾瑞克·莎莫; 
降魔传 导演: 王晶; 钟少雄; 
A Classic Tour 学友.经典世界巡回演唱会 导演: 暂无
回到未来 导演: 罗伯特·泽米吉斯; 
关于一个高中生爱情片的演奏曲 导演: NicholasZebrun; 
足球王者 导演: 刘骏; 
肥龙过江 导演: 洪金宝; 
荡寇风云 导演: 陈嘉上; 
一代宗师 导演: 张鑫炎; 
三方国界 导演: J·C·尚多尔; 
纪录片: BBC之恐怖真相 第一季 导演: NigelLevy; RupertMiles; 
惊天大逆转 导演: 李骏; 
女他 导演: 周圣崴; 
忠犬八公 导演: 暂无
跨越8年的新娘 导演: 濑濑敬久; 
密战 导演: 钟少雄; 
春天的故事 导演: 埃里克·侯麦; 
极端邪恶 导演: 乔·伯灵格; 齐德·多尔里; 
冰雪暴 导演: 暂无
昼颜 导演: 西谷弘; 
刀剑乱舞 电影版 导演: 耶云哉治; 
西游记之大圣闹天宫 导演: 田晓鹏; 
笔仙撞碟仙 导演: 摩撒利; 
赎罪 导演: 乔·赖特; 
数码宝贝大冒险tri. 第6章 导演: 元永庆太郎; 
新咒怨(美版) 导演: 尼古拉斯·佩谢; 
精灵宝可梦：大家的故事 导演: 汤山邦彦; 
冰上的尤里 剧场版 导演: 山本沙代; 
我是植物人 导演: 王竞; 
喜剧片的黄金时代 导演: RobertYoungson; 
边境杀手 导演: 丹尼斯·维伦纽瓦; 
狂怒的金佛 导演: 杨龙; 
钢铁苍穹 导演: 提莫·沃伦索拉; 
王者天下 导演: 暂无
骡子 导演: 克林特·伊斯特伍德; 
叶问前传 导演: 邱礼涛; 
铁道飞虎 导演: 丁晟; 
叶问前传 导演: 邱礼涛; 
王者天下 导演: 暂无
骡子 导演: 克林特·伊斯特伍德; 
熊出没之年货 导演: 丁亮; 刘富源; 
尖峰时刻4 导演: 暂无
斗牛 导演: 管虎; 
逃出水泥地 导演: S·克雷格·扎勒; 
哆啦A梦生日SP：谜之金字塔！？埃及大冒险 导演: 八锹新之介; 
卧虎藏龙：青冥宝剑 导演: 袁和平; 
冲天火 导演: 林岭东; 钱文锜; 
刀锋战士 导演: 斯蒂芬·诺林顿; 
樱桃小丸子：来自意大利的少年 导演: 高木淳; 
锦衣卫 导演: 李仁港; 
麻烦家族 导演: 黄磊; 
李保国 导演: 赵琦; 
未定名迪士尼动画电影 导演: 亚伦·布莱斯; 罗伯特·沃克; 
冰之下 导演: AelrunGoette; 
常在你左右 导演: 邱礼涛; 
看不见的客人 导演: 斯蒂法诺·摩尔蒂尼; 
初恋时光 导演: 殷国君; 
新龙门客栈 导演: 李惠民; 徐克; 
东北风云 导演: 暂无
尖峰时刻2 导演: 布莱特·拉特纳; 
心灵捕手 导演: 格斯·范·桑特; 
达芬奇密码 导演: 朗·霍华德; 
爱你，西蒙 导演: 格里格·伯兰蒂; 
圆梦巨人 导演: 史蒂文·斯皮尔伯格; 
电锯惊魂2 导演: 达伦·林恩·鲍斯曼; 
克隆人 导演: 杰弗利·纳赫马诺夫; 
海贼王特别篇：黄金之心 导演: 长峰达也; 
笨蛋都到齐了 导演: 刘十六; 
爬行 导演: 保罗·柴纳; 
坏种 导演: 罗伯·劳; 
神奇马戏团之动物饼干 导演: 托尼·班克罗夫特; 斯科特·克里斯汀·萨瓦; 
101次求婚 导演: 陈正道; 
玩具总动员之惊魂夜 导演: 安格斯·麦克莱恩; 安德鲁·斯坦顿; 
浴血广昌 导演: 高峰; 张馨; 
生死狙击 导演: 安东尼·福奎阿; 
乱世佳人 导演: 乔治·库克; 维克多·弗莱明; 
憨豆先生的大灾难 导演: 梅尔·史密斯; 
拯救大兵瑞恩 导演: 史蒂文·斯皮尔伯格; 
最萌警探 导演: 亚历山大·安德里尤先科; 
暗恋桃花源 导演: 赖声川; 
教父3 导演: 弗朗西斯·福特·科波拉; 
私家侦探 滨MIKE 第三话：前往任何遥远的地方 导演: 萩生田宏治; 
极盗车神2 导演: 埃德加·赖特; 
暗夜列车 导演: BrianKing; 
失恋先生 导演: 曹大伟; 
小悟空 导演: 叶伟青; 王以立; 
菲凡记忆 导演: 田重; 
妈妈咪呀2 导演: 欧·帕克; 
巴黎圣母院 导演: 迈克尔塔克纳; AlanHume; 
穿条纹睡衣的男孩 导演: 马克·赫尔曼; 
贞子大战伽椰子 导演: 白石晃士; 
幸运是我 导演: 罗耀辉; 
妈妈别哭 导演: 曹桂千; 
未来的你 导演: 曾张粤紫; 
岁月神偷 导演: 罗启锐; 
瘦长鬼影 导演: 西尔维恩·怀特; 
时间去哪儿了 导演: 沃尔特·塞勒斯; 马德哈尔·班达卡; 
风雨哈佛路 导演: 彼得·勒文; 
欧布奥特曼剧场版：赐予我羁绊之力吧 导演: 暂无
克莱尔·丹尼斯未定名科幻片 导演: 罗伯特·帕丁森; 
那一年，我爱过你 导演: 曾文丽; 
银河·奥特曼剧场Special 超极怪兽☆英雄大乱战 导演: 原口智生; 
代号基亚斯：反叛的鲁路修3之皇道 导演: 谷口悟朗; 
蜘蛛侠归来 导演: 詹姆斯·W.霍恩; 
大护法2 导演: 不思凡; 
东北往事之一剑一酒一江湖 导演: 暂无
草样年华 导演: 孙睿; 林子平; 
天长地久 导演: 刘镇伟; 
终结者2018 导演: 约瑟夫·麦克金提·尼彻; 
第一次的离别 导演: 王丽娜; 
球状闪电 导演: 暂无
神奇队长 导演: 马特·罗斯; 
黑夜传说5：血战 导演: 安娜·福斯特; 
盗爱空间之私人电影 导演: 暂无
流浪者的土地 导演: GaelMetroz; 
智齿 导演: 郑保瑞; 
遗传厄运 导演: 阿里·艾斯特; 
黑天鹅 导演: 达伦·阿伦诺夫斯基; 
血钻 导演: 爱德华·兹威克; 
侣行攻略之确认你是我的人 导演: 张力; 
周杰伦无与伦比演唱会 导演: 暂无
暗语者 导演: 韩万峰; 
吸血鬼调音师 导演: 暂无
盗墓笔记2 导演: 暂无
阴阳师 导演: TomohikoYamashita; 
探清水河 导演: 暂无
极盗者 导演: 埃里克松·科尔; 
人类清除计划4 导演: 詹姆斯·德莫纳克; 杰拉德·麦克穆雷; 
指尖 导演: LudovicBernard; 
宠儿 导演: 欧格斯·兰斯莫斯; 
寄生兽 导演: 山崎贵; 
藏北秘岭-重返无人区 导演: 饶子君; 蔡宇; 
卧底巨星 导演: 谷德昭; 
天下无贼 导演: 冯小刚; 
笔仙咒怨 导演: 邓安东; 
凌晨两点半 导演: 王静儿; 
弱点 导演: 约翰·李·汉考克; 
东北往事之血色青春 导演: 暂无
财迷 导演: 董董; 
这就是命 导演: 王丹; 
鬼妈妈 导演: 亨利·塞利克; 
解除好友2：暗网 导演: 斯蒂芬·思科; 
差等生乔曦 导演: 李克龙; 
蝙蝠侠：缄默 导演: 暂无
绝地战警3 导演: 乔·卡纳汉; 比拉勒·法拉赫; 
佩小姐的奇幻城堡 导演: 蒂姆·波顿; 
一级机密 导演: 洪基善; 
摇摆神探 导演: 暂无
齐天大圣之火焰山 导演: 林珍钊; 
小鬼当家3 导演: 拉加·高斯内尔; 
十二夜 导演: 林爱华; 
亚瑟王：斗兽争霸 导演: 盖·里奇; 
无限 导演: 安东尼·福奎阿; 
麦兜当当伴我心 导演: 谢立文; 
上海王2 导演: 胡雪桦; 
致命ID 导演: 詹姆斯·曼高德; 
摇滚藏獒 导演: 艾什·布兰农; 
最爱 导演: 顾长卫; 
在黑暗中讲述的恐怖故事 导演: 安德烈·艾弗道夫; 
大三儿 导演: 佟晟嘉; 
暮光巴黎 导演: 万沥方; 董方辰; 
悟空传2 导演: 暂无
远山的呼唤 导演: 山田洋次; 
红衣小女孩 导演: 程伟豪; 
小花仙大电影：奇迹少女 导演: 暂无
国家破产之日 导演: 崔國熙; 
玛利亚与蜘蛛侠 导演: MaríaVictoriaMenis; 
志明与春娇 导演: 彭浩翔; 
八子 导演: 高希希; 
紫罗兰永恒花园 导演: 石立太一; 小川太一; 
斯巴达300勇士 导演: 扎克·施奈德; 
玩命快递 导演: 元奎; 路易斯·莱特里尔; 
喜羊羊与灰太狼之喜气羊羊过蛇年 导演: 简耀宗; 
巫师猎人：猎杀福音战士克劳利 导演: 尼科·托福利; 
名侦探柯南：江户川柯南失踪事件 史上最惨的两天 导演: 山本泰一郎; 
桃姐 导演: 许鞍华; 
第十区 导演: 尼尔·布洛姆坎普; 
怪医杜立德 导演: 贝蒂·托马斯; 
黑社会2：以和为贵 导演: 杜琪峰; 
少年 导演: 杨树鹏; 
念书的孩子 导演: 原雅轩; 
蝴蝶效应 导演: 埃里克·布雷斯; J·麦基·格鲁伯; 
幽灵公主 导演: 宫崎骏; 
精武风云·陈真 导演: 刘伟强; 
举起手来2：追击阿多丸号 导演: 冯小宁; 
三夫 导演: 陈果; 
敢死队 导演: 西尔维斯特·史泰龙; 
